UNIPROT_ID	Name	Species
CREG1_HUMAN	cellular repressor of E1A stimulated genes 1(CREG1)	Homo sapiens
K2C72_HUMAN	keratin 72(KRT72)	Homo sapiens
TRPT1_HUMAN	tRNA phosphotransferase 1(TRPT1)	Homo sapiens
URP2_HUMAN	fermitin family member 3(FERMT3)	Homo sapiens
ABCA1_HUMAN	ATP binding cassette subfamily A member 1(ABCA1)	Homo sapiens
ABCF1_HUMAN	ATP binding cassette subfamily F member 1(ABCF1)	Homo sapiens
NRP2_HUMAN	neuropilin 2(NRP2)	Homo sapiens
ACACA_HUMAN	acetyl-CoA carboxylase alpha(ACACA)	Homo sapiens
FA50B_HUMAN	family with sequence similarity 50 member B(FAM50B)	Homo sapiens
SNP23_HUMAN	synaptosome associated protein 23(SNAP23)	Homo sapiens
SH2D7_HUMAN	SH2 domain containing 7(SH2D7)	Homo sapiens
CO4B_HUMAN	complement component 4B (Chido blood group), copy 2(C4B_2)	Homo sapiens
KLHL3_HUMAN	kelch like family member 3(KLHL3)	Homo sapiens
ACON_HUMAN	aconitase 2(ACO2)	Homo sapiens
PERM_HUMAN	myeloperoxidase(MPO)	Homo sapiens
RAPH1_HUMAN	Ras association (RalGDS/AF-6) and pleckstrin homology domains 1(RAPH1)	Homo sapiens
YH006_HUMAN	Putative chemokine-related protein FP248(FP248)	Homo sapiens
TLN2_HUMAN	talin 2(TLN2)	Homo sapiens
ACTA_HUMAN	actin, alpha 2, smooth muscle, aorta(ACTA2)	Homo sapiens
FBX10_HUMAN	F-box protein 10(FBXO10)	Homo sapiens
ACTS_HUMAN	actin, alpha 1, skeletal muscle(ACTA1)	Homo sapiens
MRC1_HUMAN	mannose receptor, C type 1(MRC1)	Homo sapiens
TEKT1_HUMAN	tektin 1(TEKT1)	Homo sapiens
ACTB_HUMAN	actin beta(ACTB)	Homo sapiens
ACTC_HUMAN	actin, alpha, cardiac muscle 1(ACTC1)	Homo sapiens
K2C71_HUMAN	keratin 71(KRT71)	Homo sapiens
RIPK1_HUMAN	receptor interacting serine/threonine kinase 1(RIPK1)	Homo sapiens
SPA12_HUMAN	serpin family A member 12(SERPINA12)	Homo sapiens
MSMB_HUMAN	microseminoprotein beta(MSMB)	Homo sapiens
MOES_HUMAN	moesin(MSN)	Homo sapiens
O6C76_HUMAN	olfactory receptor family 6 subfamily C member 76(OR6C76)	Homo sapiens
KRI1_HUMAN	KRI1 homolog(KRI1)	Homo sapiens
ACTN4_HUMAN	actinin alpha 4(ACTN4)	Homo sapiens
ACY1_HUMAN	aminoacylase 1(ACY1)	Homo sapiens
GASP2_HUMAN	ARMCX5-GPRASP2 readthrough(ARMCX5-GPRASP2)	Homo sapiens
ACTN2_HUMAN	actinin alpha 2(ACTN2)	Homo sapiens
GAPR1_HUMAN	GLI pathogenesis related 2(GLIPR2)	Homo sapiens
ADA10_HUMAN	ADAM metallopeptidase domain 10(ADAM10)	Homo sapiens
ADA_HUMAN	adenosine deaminase(ADA)	Homo sapiens
GIPC3_HUMAN	GIPC PDZ domain containing family member 3(GIPC3)	Homo sapiens
TCTE1_HUMAN	t-complex-associated-testis-expressed 1(TCTE1)	Homo sapiens
NOL4_HUMAN	nucleolar protein 4(NOL4)	Homo sapiens
WNK1_HUMAN	WNK lysine deficient protein kinase 1(WNK1)	Homo sapiens
CTNL1_HUMAN	catenin alpha like 1(CTNNAL1)	Homo sapiens
RMP_HUMAN	URI1, prefoldin like chaperone(URI1)	Homo sapiens
CATF_HUMAN	cathepsin F(CTSF)	Homo sapiens
MYH13_HUMAN	myosin heavy chain 13(MYH13)	Homo sapiens
MYO1B_HUMAN	myosin IB(MYO1B)	Homo sapiens
MCE1_HUMAN	RNA guanylyltransferase and 5'-phosphatase(RNGTT)	Homo sapiens
ADH1A_HUMAN	alcohol dehydrogenase 1A (class I), alpha polypeptide(ADH1A)	Homo sapiens
RTP3_HUMAN	receptor transporter protein 3(RTP3)	Homo sapiens
AP3D1_HUMAN	adaptor related protein complex 3 delta 1 subunit(AP3D1)	Homo sapiens
PARP1_HUMAN	poly(ADP-ribose) polymerase 1(PARP1)	Homo sapiens
IF2M_HUMAN	mitochondrial translational initiation factor 2(MTIF2)	Homo sapiens
IGFN1_HUMAN	immunoglobulin-like and fibronectin type III domain containing 1(IGFN1)	Homo sapiens
NU1M_HUMAN	NADH dehydrogenase, subunit 1 (complex I)(ND1)	Homo sapiens
MKS3_HUMAN	transmembrane protein 67(TMEM67)	Homo sapiens
INT1_HUMAN	integrator complex subunit 1(INTS1)	Homo sapiens
AP1G2_HUMAN	adaptor related protein complex 1 gamma 2 subunit(AP1G2)	Homo sapiens
PMS2_HUMAN	mismatch repair endonuclease PMS2(LOC107984056)	Homo sapiens
ASPG_HUMAN	aspartylglucosaminidase(AGA)	Homo sapiens
HSPB6_HUMAN	heat shock protein family B (small) member 6(HSPB6)	Homo sapiens
AFAM_HUMAN	afamin(AFM)	Homo sapiens
MTMR2_HUMAN	myotubularin related protein 2(MTMR2)	Homo sapiens
TANC2_HUMAN	tetratricopeptide repeat, ankyrin repeat and coiled-coil containing 2(TANC2)	Homo sapiens
AP2A2_HUMAN	adaptor related protein complex 2 alpha 2 subunit(AP2A2)	Homo sapiens
AP2A1_HUMAN	adaptor related protein complex 2 alpha 1 subunit(AP2A1)	Homo sapiens
P210L_HUMAN	nucleoporin 210 like(NUP210L)	Homo sapiens
PLD4_HUMAN	phospholipase D family member 4(PLD4)	Homo sapiens
HERC1_HUMAN	HECT and RLD domain containing E3 ubiquitin protein ligase family member 1(HERC1)	Homo sapiens
CAC1H_HUMAN	calcium voltage-gated channel subunit alpha1 H(CACNA1H)	Homo sapiens
PGCA_HUMAN	aggrecan(ACAN)	Homo sapiens
CAC1G_HUMAN	calcium voltage-gated channel subunit alpha1 G(CACNA1G)	Homo sapiens
ANGT_HUMAN	angiotensinogen(AGT)	Homo sapiens
HGFL_HUMAN	macrophage stimulating 1(MST1)	Homo sapiens
MYBB_HUMAN	MYB proto-oncogene like 2(MYBL2)	Homo sapiens
VNN1_HUMAN	vanin 1(VNN1)	Homo sapiens
MYPC2_HUMAN	myosin binding protein C, fast type(MYBPC2)	Homo sapiens
ZBT42_HUMAN	zinc finger and BTB domain containing 42(ZBTB42)	Homo sapiens
MX1_HUMAN	MX dynamin like GTPase 1(MX1)	Homo sapiens
MUTYH_HUMAN	mutY DNA glycosylase(MUTYH)	Homo sapiens
AL1A1_HUMAN	aldehyde dehydrogenase 1 family member A1(ALDH1A1)	Homo sapiens
FR1L6_HUMAN	fer-1 like family member 6(FER1L6)	Homo sapiens
CD166_HUMAN	activated leukocyte cell adhesion molecule(ALCAM)	Homo sapiens
FUBP1_HUMAN	far upstream element binding protein 1(FUBP1)	Homo sapiens
CCD80_HUMAN	coiled-coil domain containing 80(CCDC80)	Homo sapiens
FBX43_HUMAN	F-box protein 43(FBXO43)	Homo sapiens
ALK_HUMAN	anaplastic lymphoma receptor tyrosine kinase(ALK)	Homo sapiens
KCNQ5_HUMAN	potassium voltage-gated channel subfamily Q member 5(KCNQ5)	Homo sapiens
PROM1_HUMAN	prominin 1(PROM1)	Homo sapiens
WNK2_HUMAN	WNK lysine deficient protein kinase 2(WNK2)	Homo sapiens
ALDOC_HUMAN	aldolase, fructose-bisphosphate C(ALDOC)	Homo sapiens
GGH_HUMAN	gamma-glutamyl hydrolase(GGH)	Homo sapiens
SLAF5_HUMAN	CD84 molecule(CD84)	Homo sapiens
PROZ_HUMAN	protein Z, vitamin K dependent plasma glycoprotein(PROZ)	Homo sapiens
PKHH2_HUMAN	pleckstrin homology, MyTH4 and FERM domain containing H2(PLEKHH2)	Homo sapiens
PPBT_HUMAN	alkaline phosphatase, liver/bone/kidney(ALPL)	Homo sapiens
FCGBP_HUMAN	Fc fragment of IgG binding protein(FCGBP)	Homo sapiens
ASAP2_HUMAN	ArfGAP with SH3 domain, ankyrin repeat and PH domain 2(ASAP2)	Homo sapiens
SPA11_HUMAN	serpin family A member 11(SERPINA11)	Homo sapiens
GCST_HUMAN	aminomethyltransferase(AMT)	Homo sapiens
TATD1_HUMAN	TatD DNase domain containing 1(TATDN1)	Homo sapiens
ANR44_HUMAN	ankyrin repeat domain 44(ANKRD44)	Homo sapiens
AMYP_HUMAN	amylase, alpha 2A (pancreatic)(AMY2A)	Homo sapiens
FMN1_HUMAN	formin 1(FMN1)	Homo sapiens
AMY1_HUMAN	amylase, alpha 1A (salivary)(AMY1A)	Homo sapiens
ANGI_HUMAN	angiogenin(ANG)	Homo sapiens
AMY2B_HUMAN	amylase, alpha 2B (pancreatic)(AMY2B)	Homo sapiens
ANK2_HUMAN	ankyrin 2(ANK2)	Homo sapiens
NALP9_HUMAN	NLR family pyrin domain containing 9(NLRP9)	Homo sapiens
AHNK2_HUMAN	AHNAK nucleoprotein 2(AHNAK2)	Homo sapiens
AMBP_HUMAN	alpha-1-microglobulin/bikunin precursor(AMBP)	Homo sapiens
FCAMR_HUMAN	Fc fragment of IgA and IgM receptor(FCAMR)	Homo sapiens
PHAR1_HUMAN	phosphatase and actin regulator 1(PHACTR1)	Homo sapiens
MYG_HUMAN	myoglobin(MB)	Homo sapiens
FAM9B_HUMAN	family with sequence similarity 9 member B(FAM9B)	Homo sapiens
MBL2_HUMAN	mannose binding lectin 2(MBL2)	Homo sapiens
AXA2L_HUMAN	annexin A2 pseudogene 2(ANXA2P2)	Homo sapiens
CO6A5_HUMAN	collagen type VI alpha 5 chain(COL6A5)	Homo sapiens
BTAF1_HUMAN	B-TFIID TATA-box binding protein associated factor 1(BTAF1)	Homo sapiens
ANX11_HUMAN	annexin A11(ANXA11)	Homo sapiens
ANXA7_HUMAN	annexin A7(ANXA7)	Homo sapiens
TMPS4_HUMAN	transmembrane protease, serine 4(TMPRSS4)	Homo sapiens
AOC2_HUMAN	amine oxidase, copper containing 2(AOC2)	Homo sapiens
APOF_HUMAN	apolipoprotein F(APOF)	Homo sapiens
PEO1_HUMAN	twinkle mtDNA helicase(TWNK)	Homo sapiens
KCNKD_HUMAN	potassium two pore domain channel subfamily K member 13(KCNK13)	Homo sapiens
MAGB3_HUMAN	MAGE family member B3(MAGEB3)	Homo sapiens
KDM1B_HUMAN	lysine demethylase 1B(KDM1B)	Homo sapiens
MTPN_HUMAN	myotrophin(MTPN)	Homo sapiens
BAZ1B_HUMAN	bromodomain adjacent to zinc finger domain 1B(BAZ1B)	Homo sapiens
MA1A1_HUMAN	mannosidase alpha class 1A member 1(MAN1A1)	Homo sapiens
CNNM4_HUMAN	cyclin and CBS domain divalent metal cation transport mediator 4(CNNM4)	Homo sapiens
OSCAR_HUMAN	osteoclast associated, immunoglobulin-like receptor(OSCAR)	Homo sapiens
MA2A1_HUMAN	mannosidase alpha class 2A member 1(MAN2A1)	Homo sapiens
HMCN1_HUMAN	hemicentin 1(HMCN1)	Homo sapiens
APOC1_HUMAN	apolipoprotein C1(APOC1)	Homo sapiens
APOA4_HUMAN	apolipoprotein A4(APOA4)	Homo sapiens
FA98C_HUMAN	family with sequence similarity 98 member C(FAM98C)	Homo sapiens
A4_HUMAN	amyloid beta precursor protein(APP)	Homo sapiens
TMTC3_HUMAN	transmembrane and tetratricopeptide repeat containing 3(TMTC3)	Homo sapiens
APOH_HUMAN	apolipoprotein H(APOH)	Homo sapiens
APOE_HUMAN	apolipoprotein E(APOE)	Homo sapiens
APOD_HUMAN	apolipoprotein D(APOD)	Homo sapiens
APOC4_HUMAN	apolipoprotein C4(APOC4)	Homo sapiens
APOC3_HUMAN	apolipoprotein C3(APOC3)	Homo sapiens
PRS27_HUMAN	protease, serine 27(PRSS27)	Homo sapiens
APOC2_HUMAN	apolipoprotein C2(APOC2)	Homo sapiens
MAOM_HUMAN	malic enzyme 2(ME2)	Homo sapiens
CDKL2_HUMAN	cyclin dependent kinase like 2(CDKL2)	Homo sapiens
APC_HUMAN	APC, WNT signaling pathway regulator(APC)	Homo sapiens
NALP4_HUMAN	NLR family pyrin domain containing 4(NLRP4)	Homo sapiens
ZN830_HUMAN	zinc finger protein 830(ZNF830)	Homo sapiens
SAMP_HUMAN	amyloid P component, serum(APCS)	Homo sapiens
SPT16_HUMAN	spermatogenesis associated 16(SPATA16)	Homo sapiens
SLN11_HUMAN	schlafen family member 11(SLFN11)	Homo sapiens
TTC29_HUMAN	tetratricopeptide repeat domain 29(TTC29)	Homo sapiens
MEF2D_HUMAN	myocyte enhancer factor 2D(MEF2D)	Homo sapiens
PGRP1_HUMAN	peptidoglycan recognition protein 1(PGLYRP1)	Homo sapiens
HASP_HUMAN	germ cell associated 2, haspin(GSG2)	Homo sapiens
BIRC2_HUMAN	baculoviral IAP repeat containing 2(BIRC2)	Homo sapiens
CRCM_HUMAN	mutated in colorectal cancers(MCC)	Homo sapiens
MUC18_HUMAN	melanoma cell adhesion molecule(MCAM)	Homo sapiens
MYEOV_HUMAN	myeloma overexpressed(MYEOV)	Homo sapiens
MCM3_HUMAN	minichromosome maintenance complex component 3(MCM3)	Homo sapiens
NEXN_HUMAN	nexilin F-actin binding protein(NEXN)	Homo sapiens
ZN420_HUMAN	zinc finger protein 420(ZNF420)	Homo sapiens
MCM5_HUMAN	minichromosome maintenance complex component 5(MCM5)	Homo sapiens
ANR31_HUMAN	ankyrin repeat domain 31(ANKRD31)	Homo sapiens
MCM2_HUMAN	minichromosome maintenance complex component 2(MCM2)	Homo sapiens
CKAP2_HUMAN	cytoskeleton associated protein 2(CKAP2)	Homo sapiens
MCL1_HUMAN	BCL2 family apoptosis regulator(MCL1)	Homo sapiens
KS6A4_HUMAN	ribosomal protein S6 kinase A4(RPS6KA4)	Homo sapiens
PLCD3_HUMAN	phospholipase C delta 3(PLCD3)	Homo sapiens
TNR6_HUMAN	Fas cell surface death receptor(FAS)	Homo sapiens
MDHC_HUMAN	malate dehydrogenase 1(MDH1)	Homo sapiens
DCBD1_HUMAN	discoidin, CUB and LCCL domain containing 1(DCBLD1)	Homo sapiens
TDR12_HUMAN	tudor domain containing 12(TDRD12)	Homo sapiens
ARSA_HUMAN	arylsulfatase A(ARSA)	Homo sapiens
A1ATR_HUMAN	serpin family A member 2 (gene/pseudogene)(SERPINA2)	Homo sapiens
CD99_HUMAN	CD99 molecule(CD99)	Homo sapiens
FAIM3_HUMAN	Fc fragment of IgM receptor(FCMR)	Homo sapiens
XPR1_HUMAN	xenotropic and polytropic retrovirus receptor 1(XPR1)	Homo sapiens
MGP_HUMAN	matrix Gla protein(MGP)	Homo sapiens
ARRC_HUMAN	arrestin 3(ARR3)	Homo sapiens
MIF_HUMAN	macrophage migration inhibitory factor (glycosylation-inhibiting factor)(MIF)	Homo sapiens
HIPK4_HUMAN	homeodomain interacting protein kinase 4(HIPK4)	Homo sapiens
DDX21_HUMAN	DExD-box helicase 21(DDX21)	Homo sapiens
MET_HUMAN	MET proto-oncogene, receptor tyrosine kinase(MET)	Homo sapiens
OSMR_HUMAN	oncostatin M receptor(OSMR)	Homo sapiens
ASGR2_HUMAN	asialoglycoprotein receptor 2(ASGR2)	Homo sapiens
PRAP1_HUMAN	proline rich acidic protein 1(PRAP1)	Homo sapiens
E2AK4_HUMAN	eukaryotic translation initiation factor 2 alpha kinase 4(EIF2AK4)	Homo sapiens
RL7L_HUMAN	ribosomal protein L7 like 1(RPL7L1)	Homo sapiens
M3K13_HUMAN	mitogen-activated protein kinase kinase kinase 13(MAP3K13)	Homo sapiens
LYPD4_HUMAN	LY6/PLAUR domain containing 4(LYPD4)	Homo sapiens
KTI12_HUMAN	KTI12 chromatin associated homolog(KTI12)	Homo sapiens
TRFM_HUMAN	melanotransferrin(MELTF)	Homo sapiens
LRC53_HUMAN	leucine rich repeat containing 53(LRRC53)	Homo sapiens
NAR3_HUMAN	ADP-ribosyltransferase 3(ART3)	Homo sapiens
MGAT1_HUMAN	mannosyl (alpha-1,3-)-glycoprotein beta-1,2-N-acetylglucosaminyltransferase(MGAT1)	Homo sapiens
NAR4_HUMAN	ADP-ribosyltransferase 4 (Dombrock blood group)(ART4)	Homo sapiens
PI16_HUMAN	peptidase inhibitor 16(PI16)	Homo sapiens
CG071_HUMAN	chromosome 7 open reading frame 71(C7orf71)	Homo sapiens
TS1R3_HUMAN	taste 1 receptor member 3(TAS1R3)	Homo sapiens
FGD2_HUMAN	FYVE, RhoGEF and PH domain containing 2(FGD2)	Homo sapiens
ATM_HUMAN	ATM serine/threonine kinase(ATM)	Homo sapiens
MMP19_HUMAN	matrix metallopeptidase 19(MMP19)	Homo sapiens
ATF1_HUMAN	activating transcription factor 1(ATF1)	Homo sapiens
RABE1_HUMAN	rabaptin, RAB GTPase binding effector protein 1(RABEP1)	Homo sapiens
ANT3_HUMAN	serpin family C member 1(SERPINC1)	Homo sapiens
KCNQ4_HUMAN	potassium voltage-gated channel subfamily Q member 4(KCNQ4)	Homo sapiens
UBFL1_HUMAN	upstream binding transcription factor, RNA polymerase I-like 1(UBTFL1)	Homo sapiens
PRPF3_HUMAN	pre-mRNA processing factor 3(PRPF3)	Homo sapiens
P2RX6_HUMAN	purinergic receptor P2X 6(P2RX6)	Homo sapiens
MOV10_HUMAN	Mov10 RISC complex RNA helicase(MOV10)	Homo sapiens
SMC3_HUMAN	structural maintenance of chromosomes 3(SMC3)	Homo sapiens
PDLI1_HUMAN	PDZ and LIM domain 1(PDLIM1)	Homo sapiens
MOT4_HUMAN	solute carrier family 16 member 3(SLC16A3)	Homo sapiens
AFAD_HUMAN	afadin, adherens junction formation factor(AFDN)	Homo sapiens
K2C75_HUMAN	keratin 75(KRT75)	Homo sapiens
AFF1_HUMAN	AF4/FMR2 family member 1(AFF1)	Homo sapiens
TMC4_HUMAN	transmembrane channel like 4(TMC4)	Homo sapiens
MTMR7_HUMAN	myotubularin related protein 7(MTMR7)	Homo sapiens
M3K9_HUMAN	mitogen-activated protein kinase kinase kinase 9(MAP3K9)	Homo sapiens
YP015_HUMAN	vitellogenin(LOC400499)	Homo sapiens
ATPA_HUMAN	ATP synthase, H+ transporting, mitochondrial F1 complex, alpha subunit 1, cardiac muscle(ATP5A1)	Homo sapiens
MMP7_HUMAN	matrix metallopeptidase 7(MMP7)	Homo sapiens
MMP10_HUMAN	matrix metallopeptidase 10(MMP10)	Homo sapiens
ATP4A_HUMAN	ATPase H+/K+ transporting alpha subunit(ATP4A)	Homo sapiens
MMP9_HUMAN	matrix metallopeptidase 9(MMP9)	Homo sapiens
MMP2_HUMAN	matrix metallopeptidase 2(MMP2)	Homo sapiens
L37A2_HUMAN	leucine rich repeat containing 37 member A2(LRRC37A2)	Homo sapiens
AT2A2_HUMAN	ATPase sarcoplasmic/endoplasmic reticulum Ca2+ transporting 2(ATP2A2)	Homo sapiens
SNUT1_HUMAN	squamous cell carcinoma antigen recognized by T-cells 1(SART1)	Homo sapiens
TM217_HUMAN	transmembrane protein 217(TMEM217)	Homo sapiens
LDH6A_HUMAN	lactate dehydrogenase A like 6A(LDHAL6A)	Homo sapiens
SPTA3_HUMAN	spermatogenesis associated 3(SPATA3)	Homo sapiens
NPTX2_HUMAN	neuronal pentraxin 2(NPTX2)	Homo sapiens
DHX33_HUMAN	DEAH-box helicase 33(DHX33)	Homo sapiens
ANPRA_HUMAN	natriuretic peptide receptor 1(NPR1)	Homo sapiens
UFO_HUMAN	AXL receptor tyrosine kinase(AXL)	Homo sapiens
ANKH1_HUMAN	ANKHD1-EIF4EBP3 readthrough(ANKHD1-EIF4EBP3)	Homo sapiens
SEM3G_HUMAN	semaphorin 3G(SEMA3G)	Homo sapiens
V2R_HUMAN	arginine vasopressin receptor 2(AVPR2)	Homo sapiens
SMAP1_HUMAN	small ArfGAP 1(SMAP1)	Homo sapiens
MCCA_HUMAN	methylcrotonoyl-CoA carboxylase 1(MCCC1)	Homo sapiens
ZA2G_HUMAN	alpha-2-glycoprotein 1, zinc-binding(AZGP1)	Homo sapiens
BAI1_HUMAN	adhesion G protein-coupled receptor B1(ADGRB1)	Homo sapiens
SHC2_HUMAN	SHC adaptor protein 2(SHC2)	Homo sapiens
CILP2_HUMAN	cartilage intermediate layer protein 2(CILP2)	Homo sapiens
NTRK3_HUMAN	neurotrophic receptor tyrosine kinase 3(NTRK3)	Homo sapiens
EMSY_HUMAN	EMSY, BRCA2 interacting transcriptional repressor(EMSY)	Homo sapiens
NTRK2_HUMAN	neurotrophic receptor tyrosine kinase 2(NTRK2)	Homo sapiens
NUCB1_HUMAN	nucleobindin 1(NUCB1)	Homo sapiens
VATB1_HUMAN	ATPase H+ transporting V1 subunit B1(ATP6V1B1)	Homo sapiens
TCP1L_HUMAN	t-complex 10-like(TCP10L)	Homo sapiens
NUMA1_HUMAN	nuclear mitotic apparatus protein 1(NUMA1)	Homo sapiens
VATB2_HUMAN	ATPase H+ transporting V1 subunit B2(ATP6V1B2)	Homo sapiens
ROR2_HUMAN	receptor tyrosine kinase like orphan receptor 2(ROR2)	Homo sapiens
DDR2_HUMAN	discoidin domain receptor tyrosine kinase 2(DDR2)	Homo sapiens
KCNKI_HUMAN	potassium two pore domain channel subfamily K member 18(KCNK18)	Homo sapiens
CV031_HUMAN	chromosome 22 open reading frame 31(C22orf31)	Homo sapiens
NRCAM_HUMAN	neuronal cell adhesion molecule(NRCAM)	Homo sapiens
VATE1_HUMAN	ATPase H+ transporting V1 subunit E1(ATP6V1E1)	Homo sapiens
TM198_HUMAN	transmembrane protein 198(TMEM198)	Homo sapiens
FEM1C_HUMAN	fem-1 homolog C(FEM1C)	Homo sapiens
NRDC_HUMAN	nardilysin convertase(NRDC)	Homo sapiens
OAZ1_HUMAN	ornithine decarboxylase antizyme 1(OAZ1)	Homo sapiens
OPSB_HUMAN	opsin 1 (cone pigments), short-wave-sensitive(OPN1SW)	Homo sapiens
CELF4_HUMAN	CUGBP, Elav-like family member 4(CELF4)	Homo sapiens
SPDEF_HUMAN	SAM pointed domain containing ETS transcription factor(SPDEF)	Homo sapiens
LMOD1_HUMAN	leiomodin 1(LMOD1)	Homo sapiens
OMD_HUMAN	osteomodulin(OMD)	Homo sapiens
VAX2_HUMAN	ventral anterior homeobox 2(VAX2)	Homo sapiens
ODFP2_HUMAN	outer dense fiber of sperm tails 2(ODF2)	Homo sapiens
SP8_HUMAN	Sp8 transcription factor(SP8)	Homo sapiens
NUP98_HUMAN	nucleoporin 98(NUP98)	Homo sapiens
TTC5_HUMAN	tetratricopeptide repeat domain 5(TTC5)	Homo sapiens
SAM50_HUMAN	SAMM50 sorting and assembly machinery component(SAMM50)	Homo sapiens
CLH2_HUMAN	clathrin heavy chain like 1(CLTCL1)	Homo sapiens
CEAM1_HUMAN	carcinoembryonic antigen related cell adhesion molecule 1(CEACAM1)	Homo sapiens
UGGG1_HUMAN	UDP-glucose glycoprotein glucosyltransferase 1(UGGT1)	Homo sapiens
FSTL5_HUMAN	follistatin like 5(FSTL5)	Homo sapiens
HECD1_HUMAN	HECT domain E3 ubiquitin protein ligase 1(HECTD1)	Homo sapiens
OPHN1_HUMAN	oligophrenin 1(OPHN1)	Homo sapiens
BBS4_HUMAN	Bardet-Biedl syndrome 4(BBS4)	Homo sapiens
BCAT1_HUMAN	branched chain amino acid transaminase 1(BCAT1)	Homo sapiens
NIPBL_HUMAN	NIPBL, cohesin loading factor(NIPBL)	Homo sapiens
COG4_HUMAN	component of oligomeric golgi complex 4(COG4)	Homo sapiens
CHLE_HUMAN	butyrylcholinesterase(BCHE)	Homo sapiens
USP9X_HUMAN	ubiquitin specific peptidase 9, X-linked(USP9X)	Homo sapiens
SMC1A_HUMAN	structural maintenance of chromosomes 1A(SMC1A)	Homo sapiens
MIME_HUMAN	osteoglycin(OGN)	Homo sapiens
LUZP2_HUMAN	leucine zipper protein 2(LUZP2)	Homo sapiens
F149A_HUMAN	family with sequence similarity 149 member A(FAM149A)	Homo sapiens
BCL9_HUMAN	B-cell CLL/lymphoma 9(BCL9)	Homo sapiens
BTD_HUMAN	biotinidase(BTD)	Homo sapiens
PI51B_HUMAN	phosphatidylinositol-4-phosphate 5-kinase type 1 beta(PIP5K1B)	Homo sapiens
BST1_HUMAN	bone marrow stromal cell antigen 1(BST1)	Homo sapiens
TMPS3_HUMAN	transmembrane protease, serine 3(TMPRSS3)	Homo sapiens
OVGP1_HUMAN	oviductal glycoprotein 1(OVGP1)	Homo sapiens
DDTL_HUMAN	D-dopachrome tautomerase-like(DDTL)	Homo sapiens
OTX2_HUMAN	orthodenticle homeobox 2(OTX2)	Homo sapiens
H90B4_HUMAN	heat shock protein 90 alpha family class B member 4, pseudogene(HSP90AB4P)	Homo sapiens
OTX1_HUMAN	orthodenticle homeobox 1(OTX1)	Homo sapiens
ASB9_HUMAN	ankyrin repeat and SOCS box containing 9(ASB9)	Homo sapiens
EEA1_HUMAN	early endosome antigen 1(EEA1)	Homo sapiens
TAGL2_HUMAN	transgelin 2(TAGLN2)	Homo sapiens
SPRL1_HUMAN	SPARC like 1(SPARCL1)	Homo sapiens
PLPP_HUMAN	pyridoxal phosphatase(PDXP)	Homo sapiens
PAI1_HUMAN	serpin family E member 1(SERPINE1)	Homo sapiens
LTBP4_HUMAN	latent transforming growth factor beta binding protein 4(LTBP4)	Homo sapiens
LIS1_HUMAN	platelet activating factor acetylhydrolase 1b regulatory subunit 1(PAFAH1B1)	Homo sapiens
CASC5_HUMAN	kinetochore scaffold 1(KNL1)	Homo sapiens
ZN845_HUMAN	zinc finger protein 845(ZNF845)	Homo sapiens
PCSK6_HUMAN	proprotein convertase subtilisin/kexin type 6(PCSK6)	Homo sapiens
DYRK3_HUMAN	dual specificity tyrosine phosphorylation regulated kinase 3(DYRK3)	Homo sapiens
PEBP1_HUMAN	phosphatidylethanolamine binding protein 1(PEBP1)	Homo sapiens
PMGE_HUMAN	bisphosphoglycerate mutase(BPGM)	Homo sapiens
CBPO_HUMAN	carboxypeptidase O(CPO)	Homo sapiens
PDIA1_HUMAN	prolyl 4-hydroxylase subunit beta(P4HB)	Homo sapiens
DDX24_HUMAN	DEAD-box helicase 24(DDX24)	Homo sapiens
CNTN4_HUMAN	contactin 4(CNTN4)	Homo sapiens
DPP2_HUMAN	dipeptidyl peptidase 7(DPP7)	Homo sapiens
RECK_HUMAN	reversion inducing cysteine rich protein with kazal motifs(RECK)	Homo sapiens
PSMG2_HUMAN	proteasome assembly chaperone 2(PSMG2)	Homo sapiens
DTWD1_HUMAN	DTW domain containing 1(DTWD1)	Homo sapiens
CTL3_HUMAN	solute carrier family 44 member 3(SLC44A3)	Homo sapiens
CC136_HUMAN	coiled-coil domain containing 136(CCDC136)	Homo sapiens
FZD9_HUMAN	frizzled class receptor 9(FZD9)	Homo sapiens
AMD_HUMAN	peptidylglycine alpha-amidating monooxygenase(PAM)	Homo sapiens
CNTN3_HUMAN	contactin 3(CNTN3)	Homo sapiens
AT7L3_HUMAN	ataxin 7 like 3(ATXN7L3)	Homo sapiens
CAH2_HUMAN	carbonic anhydrase 2(CA2)	Homo sapiens
CAH3_HUMAN	carbonic anhydrase 3(CA3)	Homo sapiens
REG3A_HUMAN	regenerating family member 3 alpha(REG3A)	Homo sapiens
CAH1_HUMAN	carbonic anhydrase 1(CA1)	Homo sapiens
C1QB_HUMAN	complement C1q B chain(C1QB)	Homo sapiens
C1QA_HUMAN	complement C1q A chain(C1QA)	Homo sapiens
AK1BA_HUMAN	aldo-keto reductase family 1 member B10(AKR1B10)	Homo sapiens
C1QC_HUMAN	complement C1q C chain(C1QC)	Homo sapiens
CO2_HUMAN	complement C2(C2)	Homo sapiens
C1S_HUMAN	complement C1s(C1S)	Homo sapiens
PCOC1_HUMAN	procollagen C-endopeptidase enhancer(PCOLCE)	Homo sapiens
IPSP_HUMAN	serpin family A member 5(SERPINA5)	Homo sapiens
PCNA_HUMAN	proliferating cell nuclear antigen(PCNA)	Homo sapiens
IC1_HUMAN	serpin family G member 1(SERPING1)	Homo sapiens
CO6_HUMAN	complement C6(C6)	Homo sapiens
CO7_HUMAN	complement C7(C7)	Homo sapiens
CO8A_HUMAN	complement C8 alpha chain(C8A)	Homo sapiens
CO8B_HUMAN	complement C8 beta chain(C8B)	Homo sapiens
CO8G_HUMAN	complement C8 gamma chain(C8G)	Homo sapiens
CO9_HUMAN	complement C9(C9)	Homo sapiens
CO4A_HUMAN	complement C4A (Rodgers blood group)(C4A)	Homo sapiens
KIF15_HUMAN	kinesin family member 15(KIF15)	Homo sapiens
C4BPA_HUMAN	complement component 4 binding protein alpha(C4BPA)	Homo sapiens
HYAL3_HUMAN	hyaluronoglucosaminidase 3(HYAL3)	Homo sapiens
ATS9_HUMAN	ADAM metallopeptidase with thrombospondin type 1 motif 9(ADAMTS9)	Homo sapiens
C4BPB_HUMAN	complement component 4 binding protein beta(C4BPB)	Homo sapiens
CO5_HUMAN	complement C5(C5)	Homo sapiens
CAMP_HUMAN	cathelicidin antimicrobial peptide(CAMP)	Homo sapiens
CAN1_HUMAN	calpain 1(CAPN1)	Homo sapiens
CTL2_HUMAN	solute carrier family 44 member 2(SLC44A2)	Homo sapiens
MYH3_HUMAN	myosin heavy chain 3(MYH3)	Homo sapiens
MYH2_HUMAN	myosin heavy chain 2(MYH2)	Homo sapiens
APOL1_HUMAN	apolipoprotein L1(APOL1)	Homo sapiens
TCAL2_HUMAN	transcription elongation factor A like 2(TCEAL2)	Homo sapiens
CAN3_HUMAN	calpain 3(CAPN3)	Homo sapiens
API5_HUMAN	apoptosis inhibitor 5(API5)	Homo sapiens
MYH1_HUMAN	myosin heavy chain 1(MYH1)	Homo sapiens
SPS2L_HUMAN	spermatogenesis associated serine rich 2 like(SPATS2L)	Homo sapiens
BARX2_HUMAN	BARX homeobox 2(BARX2)	Homo sapiens
CPNS1_HUMAN	calpain small subunit 1(CAPNS1)	Homo sapiens
MYH10_HUMAN	myosin heavy chain 10(MYH10)	Homo sapiens
MYH6_HUMAN	myosin heavy chain 6(MYH6)	Homo sapiens
MYH8_HUMAN	myosin heavy chain 8(MYH8)	Homo sapiens
ZNFX1_HUMAN	zinc finger NFX1-type containing 1(ZNFX1)	Homo sapiens
MYH9_HUMAN	myosin heavy chain 9(MYH9)	Homo sapiens
CALU_HUMAN	calumenin(CALU)	Homo sapiens
MYLK_HUMAN	myosin light chain kinase(MYLK)	Homo sapiens
SNED1_HUMAN	sushi, nidogen and EGF like domains 1(SNED1)	Homo sapiens
CALR_HUMAN	calreticulin(CALR)	Homo sapiens
MYO7A_HUMAN	myosin VIIA(MYO7A)	Homo sapiens
PYR1_HUMAN	carbamoyl-phosphate synthetase 2, aspartate transcarbamylase, and dihydroorotase(CAD)	Homo sapiens
MYO5B_HUMAN	myosin VB(MYO5B)	Homo sapiens
MYO1E_HUMAN	myosin IE(MYO1E)	Homo sapiens
THOC2_HUMAN	THO complex 2(THOC2)	Homo sapiens
CCD14_HUMAN	coiled-coil domain containing 14(CCDC14)	Homo sapiens
PRKRA_HUMAN	protein activator of interferon induced protein kinase EIF2AK2(PRKRA)	Homo sapiens
MYOC_HUMAN	myocilin(MYOC)	Homo sapiens
SRRM3_HUMAN	serine/arginine repetitive matrix 3(SRRM3)	Homo sapiens
CALB2_HUMAN	calbindin 2(CALB2)	Homo sapiens
MYO9B_HUMAN	myosin IXB(MYO9B)	Homo sapiens
FUBP2_HUMAN	KH-type splicing regulatory protein(KHSRP)	Homo sapiens
MYO7B_HUMAN	myosin VIIB(MYO7B)	Homo sapiens
AT10A_HUMAN	ATPase phospholipid transporting 10A (putative)(ATP10A)	Homo sapiens
CAC1C_HUMAN	calcium voltage-gated channel subunit alpha1 C(CACNA1C)	Homo sapiens
AT10D_HUMAN	ATPase phospholipid transporting 10D (putative)(ATP10D)	Homo sapiens
SH3L3_HUMAN	SH3 domain binding glutamate rich protein like 3(SH3BGRL3)	Homo sapiens
AP3B1_HUMAN	adaptor related protein complex 3 beta 1 subunit(AP3B1)	Homo sapiens
FCN3_HUMAN	ficolin 3(FCN3)	Homo sapiens
UBN1_HUMAN	ubinuclein 1(UBN1)	Homo sapiens
CDK10_HUMAN	cyclin dependent kinase 10(CDK10)	Homo sapiens
CA2D1_HUMAN	calcium voltage-gated channel auxiliary subunit alpha2delta 1(CACNA2D1)	Homo sapiens
ANAG_HUMAN	N-acetyl-alpha-glucosaminidase(NAGLU)	Homo sapiens
NACAM_HUMAN	nascent polypeptide-associated complex alpha subunit(NACA)	Homo sapiens
NACA_HUMAN	nascent polypeptide-associated complex alpha subunit(NACA)	Homo sapiens
DDX31_HUMAN	DEAD-box helicase 31(DDX31)	Homo sapiens
CAC1D_HUMAN	calcium voltage-gated channel subunit alpha1 D(CACNA1D)	Homo sapiens
GP126_HUMAN	adhesion G protein-coupled receptor G6(ADGRG6)	Homo sapiens
CDCP1_HUMAN	CUB domain containing protein 1(CDCP1)	Homo sapiens
NP1L3_HUMAN	nucleosome assembly protein 1 like 3(NAP1L3)	Homo sapiens
SMCA5_HUMAN	SWI/SNF related, matrix associated, actin dependent regulator of chromatin, subfamily a, member 5(SMARCA5)	Homo sapiens
CBPA6_HUMAN	carboxypeptidase A6(CPA6)	Homo sapiens
GASR_HUMAN	cholecystokinin B receptor(CCKBR)	Homo sapiens
S61A1_HUMAN	Sec61 translocon alpha 1 subunit(SEC61A1)	Homo sapiens
SRBS2_HUMAN	sorbin and SH3 domain containing 2(SORBS2)	Homo sapiens
LYRIC_HUMAN	metadherin(MTDH)	Homo sapiens
RPGR1_HUMAN	retinitis pigmentosa GTPase regulator interacting protein 1(RPGRIP1)	Homo sapiens
TSN19_HUMAN	tetraspanin 19(TSPAN19)	Homo sapiens
CBG_HUMAN	serpin family A member 6(SERPINA6)	Homo sapiens
CUL4B_HUMAN	cullin 4B(CUL4B)	Homo sapiens
AUTS2_HUMAN	autism susceptibility candidate 2(AUTS2)	Homo sapiens
TRM11_HUMAN	tRNA methyltransferase 11 homolog(TRMT11)	Homo sapiens
CUL1_HUMAN	cullin 1(CUL1)	Homo sapiens
NIF3L_HUMAN	NGG1 interacting factor 3 like 1(NIF3L1)	Homo sapiens
PAPOG_HUMAN	poly(A) polymerase gamma(PAPOLG)	Homo sapiens
HPSE2_HUMAN	heparanase 2 (inactive)(HPSE2)	Homo sapiens
NEBU_HUMAN	nebulin(NEB)	Homo sapiens
LIPA4_HUMAN	PTPRF interacting protein alpha 4(PPFIA4)	Homo sapiens
CD248_HUMAN	CD248 molecule(CD248)	Homo sapiens
CATR1_HUMAN	CATR tumorigenicity conversion 1(CATR1)	Homo sapiens
MA1C1_HUMAN	mannosidase alpha class 1C member 1(MAN1C1)	Homo sapiens
NIPS1_HUMAN	nipsnap homolog 1 (C. elegans)(NIPSNAP1)	Homo sapiens
APMAP_HUMAN	adipocyte plasma membrane associated protein(APMAP)	Homo sapiens
CILP1_HUMAN	cartilage intermediate layer protein(CILP)	Homo sapiens
CAPZB_HUMAN	capping actin protein of muscle Z-line beta subunit(CAPZB)	Homo sapiens
RAE1L_HUMAN	ribonucleic acid export 1(RAE1)	Homo sapiens
ANKL1_HUMAN	ankyrin repeat and LEM domain containing 1(ANKLE1)	Homo sapiens
SYCC_HUMAN	cysteinyl-tRNA synthetase(CARS)	Homo sapiens
OFD1_HUMAN	OFD1, centriole and centriolar satellite protein(OFD1)	Homo sapiens
GPSM1_HUMAN	G-protein signaling modulator 1(GPSM1)	Homo sapiens
GEMI2_HUMAN	gem nuclear organelle associated protein 2(GEMIN2)	Homo sapiens
KLK13_HUMAN	kallikrein related peptidase 13(KLK13)	Homo sapiens
RTN4_HUMAN	reticulon 4(RTN4)	Homo sapiens
NIBL1_HUMAN	family with sequence similarity 129 member B(FAM129B)	Homo sapiens
TM159_HUMAN	transmembrane protein 159(TMEM159)	Homo sapiens
ZFP28_HUMAN	ZFP28 zinc finger protein(ZFP28)	Homo sapiens
CATA_HUMAN	catalase(CAT)	Homo sapiens
DCAF4_HUMAN	DDB1 and CUL4 associated factor 4(DCAF4)	Homo sapiens
NETR_HUMAN	protease, serine 12(PRSS12)	Homo sapiens
RPA1_HUMAN	RNA polymerase I subunit A(POLR1A)	Homo sapiens
ARRD4_HUMAN	arrestin domain containing 4(ARRDC4)	Homo sapiens
CRDL2_HUMAN	chordin like 2(CHRDL2)	Homo sapiens
EIF3G_HUMAN	eukaryotic translation initiation factor 3 subunit G(EIF3G)	Homo sapiens
GABP2_HUMAN	GA binding protein transcription factor beta subunit 2(GABPB2)	Homo sapiens
EIF3B_HUMAN	eukaryotic translation initiation factor 3 subunit B(EIF3B)	Homo sapiens
LTMD1_HUMAN	LETM1 domain containing 1(LETMD1)	Homo sapiens
NAA35_HUMAN	N(alpha)-acetyltransferase 35, NatC auxiliary subunit(NAA35)	Homo sapiens
CD34_HUMAN	CD34 molecule(CD34)	Homo sapiens
HES3_HUMAN	hes family bHLH transcription factor 3(HES3)	Homo sapiens
AT8B3_HUMAN	ATPase phospholipid transporting 8B3(ATP8B3)	Homo sapiens
NEO1_HUMAN	neogenin 1(NEO1)	Homo sapiens
PRA18_HUMAN	PRAME family member 18(PRAMEF18)	Homo sapiens
ABCBB_HUMAN	ATP binding cassette subfamily B member 11(ABCB11)	Homo sapiens
CD14_HUMAN	CD14 molecule(CD14)	Homo sapiens
CENPH_HUMAN	centromere protein H(CENPH)	Homo sapiens
NEK3_HUMAN	NIMA related kinase 3(NEK3)	Homo sapiens
CTCFL_HUMAN	CCCTC-binding factor like(CTCFL)	Homo sapiens
CBLN4_HUMAN	cerebellin 4 precursor(CBLN4)	Homo sapiens
CD5L_HUMAN	CD5 molecule like(CD5L)	Homo sapiens
S1PR4_HUMAN	sphingosine-1-phosphate receptor 4(S1PR4)	Homo sapiens
KRT37_HUMAN	keratin 37(KRT37)	Homo sapiens
KRT38_HUMAN	keratin 38(KRT38)	Homo sapiens
CD1B_HUMAN	CD1b molecule(CD1B)	Homo sapiens
OLM2B_HUMAN	olfactomedin like 2B(OLFML2B)	Homo sapiens
MARCO_HUMAN	macrophage receptor with collagenous structure(MARCO)	Homo sapiens
ZN287_HUMAN	zinc finger protein 287(ZNF287)	Homo sapiens
CCNT2_HUMAN	cyclin T2(CCNT2)	Homo sapiens
JPH3_HUMAN	junctophilin 3(JPH3)	Homo sapiens
NFKB1_HUMAN	nuclear factor kappa B subunit 1(NFKB1)	Homo sapiens
A2ML1_HUMAN	alpha-2-macroglobulin like 1(A2ML1)	Homo sapiens
TARSH_HUMAN	ABI family member 3 binding protein(ABI3BP)	Homo sapiens
PAMR1_HUMAN	peptidase domain containing associated with muscle regeneration 1(PAMR1)	Homo sapiens
ZBT46_HUMAN	zinc finger and BTB domain containing 46(ZBTB46)	Homo sapiens
DGLB_HUMAN	diacylglycerol lipase beta(DAGLB)	Homo sapiens
PACRL_HUMAN	PARK2 coregulated like(PACRGL)	Homo sapiens
NID1_HUMAN	nidogen 1(NID1)	Homo sapiens
F193A_HUMAN	family with sequence similarity 193 member A(FAM193A)	Homo sapiens
SYF2_HUMAN	SYF2 pre-mRNA splicing factor(SYF2)	Homo sapiens
CPNE4_HUMAN	copine 4(CPNE4)	Homo sapiens
NGF_HUMAN	nerve growth factor(NGF)	Homo sapiens
CADH3_HUMAN	cadherin 3(CDH3)	Homo sapiens
CADH5_HUMAN	cadherin 5(CDH5)	Homo sapiens
CADH6_HUMAN	cadherin 6(CDH6)	Homo sapiens
K2C79_HUMAN	keratin 79(KRT79)	Homo sapiens
NDKB_HUMAN	NME/NM23 nucleoside diphosphate kinase 2(NME2)	Homo sapiens
NDKA_HUMAN	NME/NM23 nucleoside diphosphate kinase 1(NME1)	Homo sapiens
LY6D_HUMAN	lymphocyte antigen 6 complex, locus D(LY6D)	Homo sapiens
CADH1_HUMAN	cadherin 1(CDH1)	Homo sapiens
RT06_HUMAN	mitochondrial ribosomal protein S6(MRPS6)	Homo sapiens
OASL_HUMAN	2'-5'-oligoadenylate synthetase like(OASL)	Homo sapiens
AOC3_HUMAN	amine oxidase, copper containing 3(AOC3)	Homo sapiens
CDC5L_HUMAN	cell division cycle 5 like(CDC5L)	Homo sapiens
P63_HUMAN	tumor protein p63(TP63)	Homo sapiens
ZN300_HUMAN	zinc finger protein 300(ZNF300)	Homo sapiens
TMOD2_HUMAN	tropomodulin 2(TMOD2)	Homo sapiens
NMT1_HUMAN	N-myristoyltransferase 1(NMT1)	Homo sapiens
NOVA1_HUMAN	NOVA alternative splicing regulator 1(NOVA1)	Homo sapiens
NOV_HUMAN	nephroblastoma overexpressed(NOV)	Homo sapiens
NPAT_HUMAN	nuclear protein, coactivator of histone transcription(NPAT)	Homo sapiens
PNPH_HUMAN	purine nucleoside phosphorylase(PNP)	Homo sapiens
NOTC1_HUMAN	notch 1(NOTCH1)	Homo sapiens
CD44_HUMAN	CD44 molecule (Indian blood group)(CD44)	Homo sapiens
CD59_HUMAN	CD59 molecule(CD59)	Homo sapiens
KANK2_HUMAN	KN motif and ankyrin repeat domains 2(KANK2)	Homo sapiens
NOTC3_HUMAN	notch 3(NOTCH3)	Homo sapiens
STC2_HUMAN	stanniocalcin 2(STC2)	Homo sapiens
LFA3_HUMAN	CD58 molecule(CD58)	Homo sapiens
SMOC2_HUMAN	SPARC related modular calcium binding 2(SMOC2)	Homo sapiens
CHAD_HUMAN	chondroadherin(CHAD)	Homo sapiens
VNN3_HUMAN	vanin 3(VNN3)	Homo sapiens
ST32B_HUMAN	serine/threonine kinase 32B(STK32B)	Homo sapiens
JADE3_HUMAN	jade family PHD finger 3(JADE3)	Homo sapiens
CJ120_HUMAN	chromosome 10 open reading frame 120(C10orf120)	Homo sapiens
UBP41_HUMAN	ubiquitin specific peptidase 41(USP41)	Homo sapiens
CH3L1_HUMAN	chitinase 3 like 1(CHI3L1)	Homo sapiens
CHIT1_HUMAN	chitinase 1(CHIT1)	Homo sapiens
PRP16_HUMAN	DEAH-box helicase 38(DHX38)	Homo sapiens
SNX17_HUMAN	sorting nexin 17(SNX17)	Homo sapiens
PPIC_HUMAN	peptidylprolyl isomerase C(PPIC)	Homo sapiens
DLGP5_HUMAN	DLG associated protein 5(DLGAP5)	Homo sapiens
PPGB_HUMAN	cathepsin A(CTSA)	Homo sapiens
PPIB_HUMAN	peptidylprolyl isomerase B(PPIB)	Homo sapiens
FA2H_HUMAN	fatty acid 2-hydroxylase(FA2H)	Homo sapiens
CXCL7_HUMAN	pro-platelet basic protein(PPBP)	Homo sapiens
PPE1_HUMAN	protein phosphatase with EF-hand domain 1(PPEF1)	Homo sapiens
K0232_HUMAN	KIAA0232(KIAA0232)	Homo sapiens
SCOT2_HUMAN	3-oxoacid CoA-transferase 2(OXCT2)	Homo sapiens
RHG32_HUMAN	Rho GTPase activating protein 32(ARHGAP32)	Homo sapiens
MYOME_HUMAN	phosphodiesterase 4D interacting protein-like(LOC653513)	Homo sapiens
CP110_HUMAN	centriolar coiled-coil protein 110(CCP110)	Homo sapiens
K2C74_HUMAN	keratin 74(KRT74)	Homo sapiens
CC150_HUMAN	coiled-coil domain containing 150(CCDC150)	Homo sapiens
SART3_HUMAN	squamous cell carcinoma antigen recognized by T-cells 3(SART3)	Homo sapiens
PAL4A_HUMAN	peptidylprolyl isomerase A like 4A(PPIAL4A)	Homo sapiens
PO3F4_HUMAN	POU class 3 homeobox 4(POU3F4)	Homo sapiens
SFTA1_HUMAN	surfactant protein A1(SFTPA1)	Homo sapiens
GTSE1_HUMAN	G2 and S-phase expressed 1(GTSE1)	Homo sapiens
SNPH_HUMAN	syntaphilin(SNPH)	Homo sapiens
OVOS2_HUMAN	ovostatin 2(OVOS2)	Homo sapiens
FA65B_HUMAN	family with sequence similarity 65 member B(FAM65B)	Homo sapiens
PON3_HUMAN	paraoxonase 3(PON3)	Homo sapiens
PON1_HUMAN	paraoxonase 1(PON1)	Homo sapiens
TNMD_HUMAN	tenomodulin(TNMD)	Homo sapiens
ACHA4_HUMAN	cholinergic receptor nicotinic alpha 4 subunit(CHRNA4)	Homo sapiens
RN121_HUMAN	ring finger protein 121(RNF121)	Homo sapiens
U17L3_HUMAN	ubiquitin specific peptidase 17-like family member 3(USP17L3)	Homo sapiens
HIPK1_HUMAN	homeodomain interacting protein kinase 1(HIPK1)	Homo sapiens
RPB1_HUMAN	RNA polymerase II subunit A(POLR2A)	Homo sapiens
PODXL_HUMAN	podocalyxin like(PODXL)	Homo sapiens
HEPH_HUMAN	hephaestin(HEPH)	Homo sapiens
ELMO1_HUMAN	engulfment and cell motility 1(ELMO1)	Homo sapiens
VPS54_HUMAN	VPS54, GARP complex subunit(VPS54)	Homo sapiens
RM19_HUMAN	mitochondrial ribosomal protein L19(MRPL19)	Homo sapiens
LIPP_HUMAN	pancreatic lipase(PNLIP)	Homo sapiens
TSYL2_HUMAN	TSPY like 2(TSPYL2)	Homo sapiens
SFPA2_HUMAN	surfactant protein A2(SFTPA2)	Homo sapiens
CENPO_HUMAN	centromere protein O(CENPO)	Homo sapiens
CKAP5_HUMAN	cytoskeleton associated protein 5(CKAP5)	Homo sapiens
RGF1B_HUMAN	RasGEF domain family member 1B(RASGEF1B)	Homo sapiens
CENPF_HUMAN	centromere protein F(CENPF)	Homo sapiens
NAL11_HUMAN	NLR family pyrin domain containing 11(NLRP11)	Homo sapiens
URB2_HUMAN	URB2 ribosome biogenesis 2 homolog (S. cerevisiae)(URB2)	Homo sapiens
CATC_HUMAN	cathepsin C(CTSC)	Homo sapiens
MY18A_HUMAN	myosin XVIIIA(MYO18A)	Homo sapiens
KLH21_HUMAN	kelch like family member 21(KLHL21)	Homo sapiens
ROBO3_HUMAN	roundabout guidance receptor 3(ROBO3)	Homo sapiens
MRC2_HUMAN	mannose receptor C type 2(MRC2)	Homo sapiens
STRUM_HUMAN	KIAA0196(KIAA0196)	Homo sapiens
PROC_HUMAN	protein C, inactivator of coagulation factors Va and VIIIa(PROC)	Homo sapiens
SEM4A_HUMAN	semaphorin 4A(SEMA4A)	Homo sapiens
PROS_HUMAN	protein S (alpha)(PROS1)	Homo sapiens
CL067_HUMAN	long intergenic non-protein coding RNA 477(LINC00477)	Homo sapiens
RBM19_HUMAN	RNA binding motif protein 19(RBM19)	Homo sapiens
SGSM2_HUMAN	small G protein signaling modulator 2(SGSM2)	Homo sapiens
MLKL_HUMAN	mixed lineage kinase domain like(MLKL)	Homo sapiens
LIPT_HUMAN	lipoyltransferase 1(LIPT1)	Homo sapiens
UNC80_HUMAN	unc-80 homolog, NALCN activator(UNC80)	Homo sapiens
MP2K7_HUMAN	mitogen-activated protein kinase kinase 7(MAP2K7)	Homo sapiens
GLU2B_HUMAN	protein kinase C substrate 80K-H(PRKCSH)	Homo sapiens
PR23B_HUMAN	proline rich 23B(PRR23B)	Homo sapiens
KPCD1_HUMAN	protein kinase D1(PRKD1)	Homo sapiens
CE350_HUMAN	centrosomal protein 350(CEP350)	Homo sapiens
K2013_HUMAN	KIAA2013(KIAA2013)	Homo sapiens
CNGB1_HUMAN	cyclic nucleotide gated channel beta 1(CNGB1)	Homo sapiens
KGP2_HUMAN	protein kinase, cGMP-dependent, type II(PRKG2)	Homo sapiens
CNTFR_HUMAN	ciliary neurotrophic factor receptor(CNTFR)	Homo sapiens
CNR2_HUMAN	cannabinoid receptor 2(CNR2)	Homo sapiens
TLK1_HUMAN	tousled like kinase 1(TLK1)	Homo sapiens
NPA1P_HUMAN	URB1 ribosome biogenesis 1 homolog (S. cerevisiae)(URB1)	Homo sapiens
DYH12_HUMAN	dynein axonemal heavy chain 12(DNAH12)	Homo sapiens
CO1A2_HUMAN	collagen type I alpha 2 chain(COL1A2)	Homo sapiens
KPCD_HUMAN	protein kinase C delta(PRKCD)	Homo sapiens
CO1A1_HUMAN	collagen type I alpha 1 chain(COL1A1)	Homo sapiens
KPCE_HUMAN	protein kinase C epsilon(PRKCE)	Homo sapiens
AN18A_HUMAN	ankyrin repeat domain 18A(ANKRD18A)	Homo sapiens
PRG2_HUMAN	proteoglycan 2, pro eosinophil major basic protein(PRG2)	Homo sapiens
SRGN_HUMAN	serglycin(SRGN)	Homo sapiens
RT23_HUMAN	mitochondrial ribosomal protein S23(MRPS23)	Homo sapiens
RBNS5_HUMAN	rabenosyn, RAB effector(RBSN)	Homo sapiens
PRPC_HUMAN	proline rich protein HaeIII subfamily 1(PRH1)	Homo sapiens
PRI1_HUMAN	primase (DNA) subunit 1(PRIM1)	Homo sapiens
KCRM_HUMAN	creatine kinase, M-type(CKM)	Homo sapiens
MVP_HUMAN	major vault protein(MVP)	Homo sapiens
ERCC8_HUMAN	ERCC excision repair 8, CSA ubiquitin ligase complex subunit(ERCC8)	Homo sapiens
PPP5_HUMAN	protein phosphatase 5 catalytic subunit(PPP5C)	Homo sapiens
ASB4_HUMAN	ankyrin repeat and SOCS box containing 4(ASB4)	Homo sapiens
DHTK1_HUMAN	dehydrogenase E1 and transketolase domain containing 1(DHTKD1)	Homo sapiens
NU153_HUMAN	nucleoporin 153(NUP153)	Homo sapiens
PRB3_HUMAN	proline rich protein BstNI subfamily 3(PRB3)	Homo sapiens
PCP_HUMAN	prolylcarboxypeptidase(PRCP)	Homo sapiens
DOP2_HUMAN	dopey family member 2(DOPEY2)	Homo sapiens
PPCE_HUMAN	prolyl endopeptidase(PREP)	Homo sapiens
K895L_HUMAN	KIAA0895 like(KIAA0895L)	Homo sapiens
FRMD7_HUMAN	FERM domain containing 7(FRMD7)	Homo sapiens
DPEP3_HUMAN	dipeptidase 3(DPEP3)	Homo sapiens
HELZ_HUMAN	helicase with zinc finger(HELZ)	Homo sapiens
KIF14_HUMAN	kinesin family member 14(KIF14)	Homo sapiens
RHG25_HUMAN	Rho GTPase activating protein 25(ARHGAP25)	Homo sapiens
PPR3A_HUMAN	protein phosphatase 1 regulatory subunit 3A(PPP1R3A)	Homo sapiens
U17L2_HUMAN	ubiquitin specific peptidase 17-like family member 2(USP17L2)	Homo sapiens
PEBP4_HUMAN	phosphatidylethanolamine binding protein 4(PEBP4)	Homo sapiens
NLRC3_HUMAN	NLR family CARD domain containing 3(NLRC3)	Homo sapiens
ERAP2_HUMAN	endoplasmic reticulum aminopeptidase 2(ERAP2)	Homo sapiens
GOGA5_HUMAN	golgin A5(GOLGA5)	Homo sapiens
WDR1_HUMAN	WD repeat domain 1(WDR1)	Homo sapiens
DPEP2_HUMAN	dipeptidase 2(DPEP2)	Homo sapiens
CLH1_HUMAN	clathrin heavy chain(CLTC)	Homo sapiens
CPT1B_HUMAN	carnitine palmitoyltransferase 1B(CPT1B)	Homo sapiens
DYH10_HUMAN	dynein axonemal heavy chain 10(DNAH10)	Homo sapiens
ZCHC8_HUMAN	zinc finger CCHC-type containing 8(ZCCHC8)	Homo sapiens
PGK1_HUMAN	phosphoglycerate kinase 1(PGK1)	Homo sapiens
CDR2_HUMAN	cerebellar degeneration-related protein 2(LOC101060399)	Homo sapiens
CPN2_HUMAN	carboxypeptidase N subunit 2(CPN2)	Homo sapiens
6PGD_HUMAN	phosphogluconate dehydrogenase(PGD)	Homo sapiens
PGAM2_HUMAN	phosphoglycerate mutase 2(PGAM2)	Homo sapiens
PGAM1_HUMAN	phosphoglycerate mutase 1(PGAM1)	Homo sapiens
NSD1_HUMAN	nuclear receptor binding SET domain protein 1(NSD1)	Homo sapiens
CBPD_HUMAN	carboxypeptidase D(CPD)	Homo sapiens
CBPB2_HUMAN	carboxypeptidase B2(CPB2)	Homo sapiens
PROF1_HUMAN	profilin 1(PFN1)	Homo sapiens
MTMR8_HUMAN	myotubularin related protein 8(MTMR8)	Homo sapiens
ESCO2_HUMAN	establishment of sister chromatid cohesion N-acetyltransferase 2(ESCO2)	Homo sapiens
CBPA3_HUMAN	carboxypeptidase A3(CPA3)	Homo sapiens
KI16B_HUMAN	kinesin family member 16B(KIF16B)	Homo sapiens
CERU_HUMAN	ceruloplasmin(CP)	Homo sapiens
CBPA1_HUMAN	carboxypeptidase A1(CPA1)	Homo sapiens
KI21A_HUMAN	kinesin family member 21A(KIF21A)	Homo sapiens
OIT3_HUMAN	oncoprotein induced transcript 3(OIT3)	Homo sapiens
GLCNE_HUMAN	glucosamine (UDP-N-acetyl)-2-epimerase/N-acetylmannosamine kinase(GNE)	Homo sapiens
GPVI_HUMAN	glycoprotein VI platelet(GP6)	Homo sapiens
PGM1_HUMAN	phosphoglucomutase 1(PGM1)	Homo sapiens
NEB1_HUMAN	protein phosphatase 1 regulatory subunit 9A(PPP1R9A)	Homo sapiens
PDCD6_HUMAN	programmed cell death 6(PDCD6)	Homo sapiens
PGK2_HUMAN	phosphoglycerate kinase 2(PGK2)	Homo sapiens
DYH3_HUMAN	dynein axonemal heavy chain 3(DNAH3)	Homo sapiens
PF4V_HUMAN	platelet factor 4 variant 1(PF4V1)	Homo sapiens
PLF4_HUMAN	platelet factor 4(PF4)	Homo sapiens
CRY1_HUMAN	cryptochrome circadian clock 1(CRY1)	Homo sapiens
PROP_HUMAN	complement factor properdin(CFP)	Homo sapiens
CRX_HUMAN	cone-rod homeobox(CRX)	Homo sapiens
CRP_HUMAN	C-reactive protein(CRP)	Homo sapiens
DPYL1_HUMAN	collapsin response mediator protein 1(CRMP1)	Homo sapiens
NALDL_HUMAN	N-acetylated alpha-linked acidic dipeptidase like 1(NAALADL1)	Homo sapiens
CRHBP_HUMAN	corticotropin releasing hormone binding protein(CRHBP)	Homo sapiens
PEPD_HUMAN	peptidase D(PEPD)	Homo sapiens
SOX6_HUMAN	SRY-box 6(SOX6)	Homo sapiens
K2C78_HUMAN	keratin 78(KRT78)	Homo sapiens
CR2_HUMAN	complement C3d receptor 2(CR2)	Homo sapiens
PP4R1_HUMAN	protein phosphatase 4 regulatory subunit 1(PPP4R1)	Homo sapiens
CD109_HUMAN	CD109 molecule(CD109)	Homo sapiens
EMAL5_HUMAN	echinoderm microtubule associated protein like 5(EML5)	Homo sapiens
CR1_HUMAN	complement C3b/C4b receptor 1 (Knops blood group)(CR1)	Homo sapiens
ODPB_HUMAN	pyruvate dehydrogenase (lipoamide) beta(PDHB)	Homo sapiens
PPIF_HUMAN	peptidylprolyl isomerase F(PPIF)	Homo sapiens
DDX27_HUMAN	DEAD-box helicase 27(DDX27)	Homo sapiens
COMP_HUMAN	cartilage oligomeric matrix protein(COMP)	Homo sapiens
ENPP1_HUMAN	ectonucleotide pyrophosphatase/phosphodiesterase 1(ENPP1)	Homo sapiens
GMPR2_HUMAN	guanosine monophosphate reductase 2(GMPR2)	Homo sapiens
SCRN2_HUMAN	secernin 2(SCRN2)	Homo sapiens
GOLM1_HUMAN	golgi membrane protein 1(GOLM1)	Homo sapiens
PGFRB_HUMAN	platelet derived growth factor receptor beta(PDGFRB)	Homo sapiens
COBA2_HUMAN	collagen type XI alpha 2 chain(COL11A2)	Homo sapiens
XKR5_HUMAN	XK related 5(XKR5)	Homo sapiens
PEDF_HUMAN	serpin family F member 1(SERPINF1)	Homo sapiens
CO6A2_HUMAN	collagen type VI alpha 2 chain(COL6A2)	Homo sapiens
CO6A3_HUMAN	collagen type VI alpha 3 chain(COL6A3)	Homo sapiens
CD37L_HUMAN	cell division cycle 37 like 1(CDC37L1)	Homo sapiens
CDKL3_HUMAN	cyclin dependent kinase like 3(CDKL3)	Homo sapiens
NPL4_HUMAN	NPL4 homolog, ubiquitin recognition factor(NPLOC4)	Homo sapiens
CO2A1_HUMAN	collagen type II alpha 1 chain(COL2A1)	Homo sapiens
ENPP2_HUMAN	ectonucleotide pyrophosphatase/phosphodiesterase 2(ENPP2)	Homo sapiens
PQBP1_HUMAN	polyglutamine binding protein 1(PQBP1)	Homo sapiens
HUWE1_HUMAN	HECT, UBA and WWE domain containing 1, E3 ubiquitin protein ligase(HUWE1)	Homo sapiens
GGT6_HUMAN	gamma-glutamyltransferase 6(GGT6)	Homo sapiens
LRC40_HUMAN	leucine rich repeat containing 40(LRRC40)	Homo sapiens
VP13B_HUMAN	vacuolar protein sorting 13 homolog B(VPS13B)	Homo sapiens
TMHS_HUMAN	lipoma HMGIC fusion partner-like 5(LHFPL5)	Homo sapiens
ZN407_HUMAN	zinc finger protein 407(ZNF407)	Homo sapiens
DOC10_HUMAN	dedicator of cytokinesis 10(DOCK10)	Homo sapiens
TASP1_HUMAN	taspase 1(TASP1)	Homo sapiens
ASAP3_HUMAN	ArfGAP with SH3 domain, ankyrin repeat and PH domain 3(ASAP3)	Homo sapiens
RSRC1_HUMAN	arginine and serine rich coiled-coil 1(RSRC1)	Homo sapiens
ATL5_HUMAN	ADAMTS like 5(ADAMTSL5)	Homo sapiens
5NT1B_HUMAN	NT5C1B-RDH14 readthrough(NT5C1B-RDH14)	Homo sapiens
PDE1A_HUMAN	phosphodiesterase 1A(PDE1A)	Homo sapiens
P20D2_HUMAN	peptidase M20 domain containing 2(PM20D2)	Homo sapiens
SMC4_HUMAN	structural maintenance of chromosomes 4(SMC4)	Homo sapiens
SYBU_HUMAN	syntabulin(SYBU)	Homo sapiens
UN13D_HUMAN	unc-13 homolog D(UNC13D)	Homo sapiens
GCNT4_HUMAN	glucosaminyl (N-acetyl) transferase 4, core 2(GCNT4)	Homo sapiens
K22O_HUMAN	keratin 76(KRT76)	Homo sapiens
AHNK_HUMAN	AHNAK nucleoprotein(AHNAK)	Homo sapiens
CMC2_HUMAN	solute carrier family 25 member 13(SLC25A13)	Homo sapiens
PLK1_HUMAN	polo like kinase 1(PLK1)	Homo sapiens
FARP1_HUMAN	FERM, ARH/RhoGEF and pleckstrin domain protein 1(FARP1)	Homo sapiens
TAOK3_HUMAN	TAO kinase 3(TAOK3)	Homo sapiens
A2AP_HUMAN	serpin family F member 2(SERPINF2)	Homo sapiens
VINEX_HUMAN	sorbin and SH3 domain containing 3(SORBS3)	Homo sapiens
PLST_HUMAN	plastin 3(PLS3)	Homo sapiens
CTND1_HUMAN	catenin delta 1(CTNND1)	Homo sapiens
PLSI_HUMAN	plastin 1(PLS1)	Homo sapiens
IQCC_HUMAN	IQ motif containing C(IQCC)	Homo sapiens
SPTN5_HUMAN	spectrin beta, non-erythrocytic 5(SPTBN5)	Homo sapiens
CSTF1_HUMAN	cleavage stimulation factor subunit 1(CSTF1)	Homo sapiens
PLXB1_HUMAN	plexin B1(PLXNB1)	Homo sapiens
CYTM_HUMAN	cystatin E/M(CST6)	Homo sapiens
PLXA1_HUMAN	plexin A1(PLXNA1)	Homo sapiens
PLTP_HUMAN	phospholipid transfer protein(PLTP)	Homo sapiens
CTBP1_HUMAN	C-terminal binding protein 1(CTBP1)	Homo sapiens
MYP2_HUMAN	peripheral myelin protein 2(PMP2)	Homo sapiens
DIAC_HUMAN	chitobiase(CTBS)	Homo sapiens
CRNL1_HUMAN	crooked neck pre-mRNA splicing factor 1(CRNKL1)	Homo sapiens
RASL2_HUMAN	RAS p21 protein activator 4(RASA4)	Homo sapiens
ZCH12_HUMAN	zinc finger CCHC-type containing 12(ZCCHC12)	Homo sapiens
GPX6_HUMAN	glutathione peroxidase 6(GPX6)	Homo sapiens
OPTN_HUMAN	optineurin(OPTN)	Homo sapiens
BAP31_HUMAN	B-cell receptor-associated protein 31(BCAP31)	Homo sapiens
CATS_HUMAN	cathepsin S(CTSS)	Homo sapiens
FRY_HUMAN	FRY microtubule binding protein(FRY)	Homo sapiens
PDIA6_HUMAN	protein disulfide isomerase family A member 6(PDIA6)	Homo sapiens
CATZ_HUMAN	cathepsin Z(CTSZ)	Homo sapiens
TRAP1_HUMAN	TNF receptor associated protein 1(TRAP1)	Homo sapiens
KPYM_HUMAN	pyruvate kinase, muscle(PKM)	Homo sapiens
AKAP9_HUMAN	A-kinase anchoring protein 9(AKAP9)	Homo sapiens
XIRP1_HUMAN	xin actin binding repeat containing 1(XIRP1)	Homo sapiens
CLC3A_HUMAN	C-type lectin domain family 3 member A(CLEC3A)	Homo sapiens
YETS2_HUMAN	YEATS domain containing 2(YEATS2)	Homo sapiens
CATD_HUMAN	cathepsin D(CTSD)	Homo sapiens
CATB_HUMAN	cathepsin B(CTSB)	Homo sapiens
UBR5_HUMAN	ubiquitin protein ligase E3 component n-recognin 5(UBR5)	Homo sapiens
G45IP_HUMAN	GADD45G interacting protein 1(GADD45GIP1)	Homo sapiens
P20D1_HUMAN	peptidase M20 domain containing 1(PM20D1)	Homo sapiens
TRYB2_HUMAN	tryptase beta 2 (gene/pseudogene)(TPSB2)	Homo sapiens
RADIL_HUMAN	Rap associating with DIL domain(RADIL)	Homo sapiens
UROK_HUMAN	plasminogen activator, urokinase(PLAU)	Homo sapiens
PLCB3_HUMAN	phospholipase C beta 3(PLCB3)	Homo sapiens
CREL1_HUMAN	cysteine rich with EGF like domains 1(CRELD1)	Homo sapiens
GRP1_HUMAN	RAS guanyl releasing protein 1(RASGRP1)	Homo sapiens
PLMN_HUMAN	plasminogen(PLG)	Homo sapiens
DUS26_HUMAN	dual specificity phosphatase 26 (putative)(DUSP26)	Homo sapiens
RT17_HUMAN	mitochondrial ribosomal protein S17(MRPS17)	Homo sapiens
PLGB_HUMAN	plasminogen-like B2(PLGLB2)	Homo sapiens
CATH_HUMAN	cathepsin H(CTSH)	Homo sapiens
COL11_HUMAN	collectin subfamily member 11(COLEC11)	Homo sapiens
CATL1_HUMAN	cathepsin L(CTSL)	Homo sapiens
GRDN_HUMAN	coiled-coil domain containing 88A(CCDC88A)	Homo sapiens
PLIN3_HUMAN	perilipin 3(PLIN3)	Homo sapiens
ZN839_HUMAN	zinc finger protein 839(ZNF839)	Homo sapiens
TOE1_HUMAN	target of EGR1, member 1 (nuclear)(TOE1)	Homo sapiens
CSF1_HUMAN	colony stimulating factor 1(CSF1)	Homo sapiens
MSLN_HUMAN	mesothelin(MSLN)	Homo sapiens
OVOS1_HUMAN	ovostatin(OVOS)	Homo sapiens
P85A_HUMAN	phosphoinositide-3-kinase regulatory subunit 1(PIK3R1)	Homo sapiens
CSF1R_HUMAN	colony stimulating factor 1 receptor(CSF1R)	Homo sapiens
MED30_HUMAN	mediator complex subunit 30(MED30)	Homo sapiens
CAD22_HUMAN	cadherin 22(CDH22)	Homo sapiens
ESIP1_HUMAN	epithelial stromal interaction 1(EPSTI1)	Homo sapiens
SCMC3_HUMAN	solute carrier family 25 member 23(SLC25A23)	Homo sapiens
PI42A_HUMAN	phosphatidylinositol-5-phosphate 4-kinase type 2 alpha(PIP4K2A)	Homo sapiens
PRG4_HUMAN	proteoglycan 4(PRG4)	Homo sapiens
PITX2_HUMAN	paired like homeodomain 2(PITX2)	Homo sapiens
MDGA2_HUMAN	MAM domain containing glycosylphosphatidylinositol anchor 2(MDGA2)	Homo sapiens
TSH1_HUMAN	teashirt zinc finger homeobox 1(TSHZ1)	Homo sapiens
ASPC1_HUMAN	ASPSCR1, UBX domain containing tether for SLC2A4(ASPSCR1)	Homo sapiens
CSPG2_HUMAN	versican(VCAN)	Homo sapiens
CNDP2_HUMAN	CNDP dipeptidase 2 (metallopeptidase M20 family)(CNDP2)	Homo sapiens
NCAN_HUMAN	neurocan(NCAN)	Homo sapiens
CCAR1_HUMAN	cell division cycle and apoptosis regulator 1(CCAR1)	Homo sapiens
CSPG4_HUMAN	chondroitin sulfate proteoglycan 4(CSPG4)	Homo sapiens
CK5P2_HUMAN	CDK5 regulatory subunit associated protein 2(CDK5RAP2)	Homo sapiens
SHPRH_HUMAN	SNF2 histone linker PHD RING helicase(SHPRH)	Homo sapiens
FTO_HUMAN	FTO, alpha-ketoglutarate dependent dioxygenase(FTO)	Homo sapiens
CF141_HUMAN	chromosome 6 open reading frame 141(C6orf141)	Homo sapiens
PCYOX_HUMAN	prenylcysteine oxidase 1(PCYOX1)	Homo sapiens
TRI13_HUMAN	tripartite motif containing 13(TRIM13)	Homo sapiens
CYTC_HUMAN	cystatin C(CST3)	Homo sapiens
INADL_HUMAN	PATJ, crumbs cell polarity complex component(PATJ)	Homo sapiens
UGGG2_HUMAN	UDP-glucose glycoprotein glucosyltransferase 2(UGGT2)	Homo sapiens
CSF3R_HUMAN	colony stimulating factor 3 receptor(CSF3R)	Homo sapiens
KLH34_HUMAN	kelch like family member 34(KLHL34)	Homo sapiens
ZDH20_HUMAN	zinc finger DHHC-type containing 20(ZDHHC20)	Homo sapiens
VATE2_HUMAN	ATPase H+ transporting V1 subunit E2(ATP6V1E2)	Homo sapiens
KAIN_HUMAN	serpin family A member 4(SERPINA4)	Homo sapiens
TTC17_HUMAN	tetratricopeptide repeat domain 17(TTC17)	Homo sapiens
DDX41_HUMAN	DEAD-box helicase 41(DDX41)	Homo sapiens
SCAR3_HUMAN	scavenger receptor class A member 3(SCARA3)	Homo sapiens
SPB9_HUMAN	serpin family B member 9(SERPINB9)	Homo sapiens
APC5_HUMAN	anaphase promoting complex subunit 5(ANAPC5)	Homo sapiens
FA8A1_HUMAN	family with sequence similarity 8 member A1(FAM8A1)	Homo sapiens
REST_HUMAN	RE1 silencing transcription factor(REST)	Homo sapiens
DDB1_HUMAN	damage specific DNA binding protein 1(DDB1)	Homo sapiens
CAND1_HUMAN	cullin associated and neddylation dissociated 1(CAND1)	Homo sapiens
MMAA_HUMAN	methylmalonic aciduria (cobalamin deficiency) cblA type(MMAA)	Homo sapiens
DLG5_HUMAN	discs large MAGUK scaffold protein 5(DLG5)	Homo sapiens
DDC_HUMAN	dopa decarboxylase(DDC)	Homo sapiens
REG1B_HUMAN	regenerating family member 1 beta(REG1B)	Homo sapiens
DCK_HUMAN	deoxycytidine kinase(DCK)	Homo sapiens
ACE_HUMAN	angiotensin I converting enzyme(ACE)	Homo sapiens
REG1A_HUMAN	regenerating family member 1 alpha(REG1A)	Homo sapiens
FRYL_HUMAN	FRY like transcription coactivator(FRYL)	Homo sapiens
DDX10_HUMAN	DEAD-box helicase 10(DDX10)	Homo sapiens
RECQ1_HUMAN	RecQ like helicase(RECQL)	Homo sapiens
VPS11_HUMAN	VPS11, CORVET/HOPS core subunit(VPS11)	Homo sapiens
RCN1_HUMAN	reticulocalbin 1(RCN1)	Homo sapiens
EFHC1_HUMAN	EF-hand domain containing 1(EFHC1)	Homo sapiens
RECO_HUMAN	recoverin(RCVRN)	Homo sapiens
CC121_HUMAN	coiled-coil domain containing 121(CCDC121)	Homo sapiens
DDX1_HUMAN	DEAD-box helicase 1(DDX1)	Homo sapiens
CCPG1_HUMAN	cell cycle progression 1(CCPG1)	Homo sapiens
MFHA1_HUMAN	malignant fibrous histiocytoma amplified sequence 1(MFHAS1)	Homo sapiens
ASH1L_HUMAN	ASH1 like histone lysine methyltransferase(ASH1L)	Homo sapiens
RPAP3_HUMAN	RNA polymerase II associated protein 3(RPAP3)	Homo sapiens
RGS7_HUMAN	regulator of G-protein signaling 7(RGS7)	Homo sapiens
DAF_HUMAN	CD55 molecule (Cromer blood group)(CD55)	Homo sapiens
DAG1_HUMAN	dystroglycan 1(DAG1)	Homo sapiens
NUMBL_HUMAN	NUMB like, endocytic adaptor protein(NUMBL)	Homo sapiens
CA2D2_HUMAN	calcium voltage-gated channel auxiliary subunit alpha2delta 2(CACNA2D2)	Homo sapiens
RASF6_HUMAN	Ras association domain family member 6(RASSF6)	Homo sapiens
TEX2_HUMAN	testis expressed 2(TEX2)	Homo sapiens
TUT7_HUMAN	zinc finger CCHC-type containing 6(ZCCHC6)	Homo sapiens
DAZL_HUMAN	deleted in azoospermia like(DAZL)	Homo sapiens
ANR11_HUMAN	ankyrin repeat domain 11(ANKRD11)	Homo sapiens
DOPO_HUMAN	dopamine beta-hydroxylase(DBH)	Homo sapiens
RARR2_HUMAN	retinoic acid receptor responder 2(RARRES2)	Homo sapiens
RARA_HUMAN	retinoic acid receptor alpha(RARA)	Homo sapiens
FHOD1_HUMAN	formin homology 2 domain containing 1(FHOD1)	Homo sapiens
SCG3_HUMAN	secretogranin III(SCG3)	Homo sapiens
CCD38_HUMAN	coiled-coil domain containing 38(CCDC38)	Homo sapiens
RAGP1_HUMAN	Ran GTPase activating protein 1(RANGAP1)	Homo sapiens
LRRK1_HUMAN	leucine rich repeat kinase 1(LRRK1)	Homo sapiens
TMM8C_HUMAN	transmembrane protein 8C(TMEM8C)	Homo sapiens
SSU72_HUMAN	SSU72 homolog, RNA polymerase II CTD phosphatase(SSU72)	Homo sapiens
RAG1_HUMAN	recombination activating 1(RAG1)	Homo sapiens
NO66_HUMAN	chromosome 14 open reading frame 169(C14orf169)	Homo sapiens
RET4_HUMAN	retinol binding protein 4(RBP4)	Homo sapiens
CP1A2_HUMAN	cytochrome P450 family 1 subfamily A member 2(CYP1A2)	Homo sapiens
MYO5C_HUMAN	myosin VC(MYO5C)	Homo sapiens
TRIPC_HUMAN	thyroid hormone receptor interactor 12(TRIP12)	Homo sapiens
THAP9_HUMAN	THAP domain containing 9(THAP9)	Homo sapiens
PTER_HUMAN	phosphotriesterase related(PTER)	Homo sapiens
KCNB2_HUMAN	potassium voltage-gated channel subfamily B member 2(KCNB2)	Homo sapiens
CYLC2_HUMAN	cylicin 2(CYLC2)	Homo sapiens
RM18_HUMAN	mitochondrial ribosomal protein L18(MRPL18)	Homo sapiens
VAMP3_HUMAN	vesicle associated membrane protein 3(VAMP3)	Homo sapiens
ATS17_HUMAN	ADAM metallopeptidase with thrombospondin type 1 motif 17(ADAMTS17)	Homo sapiens
RBM3_HUMAN	RNA binding motif (RNP1, RRM) protein 3(RBM3)	Homo sapiens
CC113_HUMAN	coiled-coil domain containing 113(CCDC113)	Homo sapiens
ATS18_HUMAN	ADAM metallopeptidase with thrombospondin type 1 motif 18(ADAMTS18)	Homo sapiens
C163A_HUMAN	CD163 molecule(CD163)	Homo sapiens
B4GT5_HUMAN	beta-1,4-galactosyltransferase 5(B4GALT5)	Homo sapiens
TF3C4_HUMAN	general transcription factor IIIC subunit 4(GTF3C4)	Homo sapiens
Z385D_HUMAN	zinc finger protein 385D(ZNF385D)	Homo sapiens
TAOK2_HUMAN	TAO kinase 2(TAOK2)	Homo sapiens
DYH5_HUMAN	dynein axonemal heavy chain 5(DNAH5)	Homo sapiens
RP1_HUMAN	retinitis pigmentosa 1 (autosomal dominant)(RP1)	Homo sapiens
DYH9_HUMAN	dynein axonemal heavy chain 9(DNAH9)	Homo sapiens
SLIT2_HUMAN	slit guidance ligand 2(SLIT2)	Homo sapiens
DYH6_HUMAN	dynein axonemal heavy chain 6(DNAH6)	Homo sapiens
GAK8_HUMAN	endogenous retrovirus group K member 8(ERVK-8)	Homo sapiens
CTSR1_HUMAN	cation channel sperm associated 1(CATSPER1)	Homo sapiens
DYHC1_HUMAN	dynein cytoplasmic 1 heavy chain 1(DYNC1H1)	Homo sapiens
APOM_HUMAN	apolipoprotein M(APOM)	Homo sapiens
DNSL3_HUMAN	deoxyribonuclease 1 like 3(DNASE1L3)	Homo sapiens
LONM_HUMAN	lon peptidase 1, mitochondrial(LONP1)	Homo sapiens
GEMI7_HUMAN	gem nuclear organelle associated protein 7(GEMIN7)	Homo sapiens
KLOT_HUMAN	klotho(KL)	Homo sapiens
ADIPO_HUMAN	adiponectin, C1Q and collagen domain containing(ADIPOQ)	Homo sapiens
ROBO1_HUMAN	roundabout guidance receptor 1(ROBO1)	Homo sapiens
NRX3A_HUMAN	neurexin 3(NRXN3)	Homo sapiens
CABL2_HUMAN	Cdk5 and Abl enzyme substrate 2(CABLES2)	Homo sapiens
TM9S2_HUMAN	transmembrane 9 superfamily member 2(TM9SF2)	Homo sapiens
ROBO2_HUMAN	roundabout guidance receptor 2(ROBO2)	Homo sapiens
DNM3A_HUMAN	DNA methyltransferase 3 alpha(DNMT3A)	Homo sapiens
NRX2A_HUMAN	neurexin 2(NRXN2)	Homo sapiens
ZFHX4_HUMAN	zinc finger homeobox 4(ZFHX4)	Homo sapiens
COG1_HUMAN	component of oligomeric golgi complex 1(COG1)	Homo sapiens
DKC1_HUMAN	dyskerin pseudouridine synthase 1(DKC1)	Homo sapiens
DLDH_HUMAN	dihydrolipoamide dehydrogenase(DLD)	Homo sapiens
RB12B_HUMAN	RNA binding motif protein 12B(RBM12B)	Homo sapiens
CC126_HUMAN	coiled-coil domain containing 126(CCDC126)	Homo sapiens
DCD_HUMAN	dermcidin(DCD)	Homo sapiens
RM13_HUMAN	mitochondrial ribosomal protein L13(MRPL13)	Homo sapiens
CTSR2_HUMAN	cation channel sperm associated 2(CATSPER2)	Homo sapiens
STML1_HUMAN	stomatin like 1(STOML1)	Homo sapiens
RECQ4_HUMAN	RecQ like helicase 4(RECQL4)	Homo sapiens
RL3_HUMAN	ribosomal protein L3(RPL3)	Homo sapiens
RL5_HUMAN	ribosomal protein L5(RPL5)	Homo sapiens
SARDH_HUMAN	sarcosine dehydrogenase(SARDH)	Homo sapiens
ZRAB2_HUMAN	zinc finger RANBP2-type containing 2(ZRANB2)	Homo sapiens
RNAS4_HUMAN	ribonuclease A family member 4(RNASE4)	Homo sapiens
SLTM_HUMAN	SAFB like transcription modulator(SLTM)	Homo sapiens
RNAS2_HUMAN	ribonuclease A family member 2(RNASE2)	Homo sapiens
EHMT1_HUMAN	euchromatic histone lysine methyltransferase 1(EHMT1)	Homo sapiens
RNAS1_HUMAN	ribonuclease A family member 1, pancreatic(RNASE1)	Homo sapiens
RHG29_HUMAN	Rho GTPase activating protein 29(ARHGAP29)	Homo sapiens
ACAD9_HUMAN	acyl-CoA dehydrogenase family member 9(ACAD9)	Homo sapiens
CTSRB_HUMAN	cation channel sperm associated auxiliary subunit beta(CATSPERB)	Homo sapiens
DYR_HUMAN	dihydrofolate reductase(DHFR)	Homo sapiens
RLBP1_HUMAN	retinaldehyde binding protein 1(RLBP1)	Homo sapiens
SPD2B_HUMAN	SH3 and PX domains 2B(SH3PXD2B)	Homo sapiens
MED23_HUMAN	mediator complex subunit 23(MED23)	Homo sapiens
LONF3_HUMAN	LON peptidase N-terminal domain and ring finger 3(LONRF3)	Homo sapiens
PI42C_HUMAN	phosphatidylinositol-5-phosphate 4-kinase type 2 gamma(PIP4K2C)	Homo sapiens
DEF3_HUMAN	defensin alpha 3(DEFA3)	Homo sapiens
CBPC2_HUMAN	ATP/GTP binding protein like 2(AGBL2)	Homo sapiens
GSTO1_HUMAN	glutathione S-transferase omega 1(GSTO1)	Homo sapiens
MED17_HUMAN	mediator complex subunit 17(MED17)	Homo sapiens
DEF1_HUMAN	defensin alpha 1(DEFA1)	Homo sapiens
LIGO3_HUMAN	leucine rich repeat and Ig domain containing 3(LINGO3)	Homo sapiens
DFFA_HUMAN	DNA fragmentation factor subunit alpha(DFFA)	Homo sapiens
ITM2A_HUMAN	integral membrane protein 2A(ITM2A)	Homo sapiens
FREM3_HUMAN	FRAS1 related extracellular matrix 3(FREM3)	Homo sapiens
CSPP1_HUMAN	centrosome and spindle pole associated protein 1(CSPP1)	Homo sapiens
K0825_HUMAN	KIAA0825(KIAA0825)	Homo sapiens
K2C1B_HUMAN	keratin 77(KRT77)	Homo sapiens
CFAD_HUMAN	complement factor D(CFD)	Homo sapiens
DESM_HUMAN	desmin(DES)	Homo sapiens
PICK1_HUMAN	protein interacting with PRKCA 1(PICK1)	Homo sapiens
RINI_HUMAN	ribonuclease/angiogenin inhibitor 1(RNH1)	Homo sapiens
TBAL3_HUMAN	tubulin alpha like 3(TUBAL3)	Homo sapiens
KV112_HUMAN	immunoglobulin kappa variable 1-12(IGKV1-12)	Homo sapiens
PALM2_HUMAN	paralemmin 2(PALM2)	Homo sapiens
TRML2_HUMAN	triggering receptor expressed on myeloid cells like 2(TREML2)	Homo sapiens
KV117_HUMAN	immunoglobulin kappa variable 1-17(IGKV1-17)	Homo sapiens
RPAP2_HUMAN	RNA polymerase II associated protein 2(RPAP2)	Homo sapiens
KV116_HUMAN	immunoglobulin kappa variable 1-16(IGKV1-16)	Homo sapiens
3BP5_HUMAN	SH3 domain binding protein 5(SH3BP5)	Homo sapiens
S4A7_HUMAN	solute carrier family 4 member 7(SLC4A7)	Homo sapiens
TM7S3_HUMAN	transmembrane 7 superfamily member 3(TM7SF3)	Homo sapiens
KV401_HUMAN	immunoglobulin kappa variable 4-1(IGKV4-1)	Homo sapiens
PRS7_HUMAN	proteasome 26S subunit, ATPase 2(PSMC2)	Homo sapiens
SPRE2_HUMAN	sprouty related EVH1 domain containing 2(SPRED2)	Homo sapiens
PSME1_HUMAN	proteasome activator subunit 1(PSME1)	Homo sapiens
PSME2_HUMAN	proteasome activator subunit 2(PSME2)	Homo sapiens
ERAP1_HUMAN	endoplasmic reticulum aminopeptidase 1(ERAP1)	Homo sapiens
PTBP1_HUMAN	polypyrimidine tract binding protein 1(PTBP1)	Homo sapiens
S1PR1_HUMAN	sphingosine-1-phosphate receptor 1(S1PR1)	Homo sapiens
O2AP1_HUMAN	olfactory receptor family 2 subfamily AP member 1(OR2AP1)	Homo sapiens
HMGN5_HUMAN	high mobility group nucleosome binding domain 5(HMGN5)	Homo sapiens
PSMD8_HUMAN	proteasome 26S subunit, non-ATPase 8(PSMD8)	Homo sapiens
ROCK2_HUMAN	Rho associated coiled-coil containing protein kinase 2(ROCK2)	Homo sapiens
ECM1_HUMAN	extracellular matrix protein 1(ECM1)	Homo sapiens
PSD12_HUMAN	proteasome 26S subunit, non-ATPase 12(PSMD12)	Homo sapiens
ECT2_HUMAN	epithelial cell transforming 2(ECT2)	Homo sapiens
CABP1_HUMAN	calcium binding protein 1(CABP1)	Homo sapiens
BAG5_HUMAN	BCL2 associated athanogene 5(BAG5)	Homo sapiens
KV311_HUMAN	immunoglobulin kappa variable 3D-11(IGKV3D-11)	Homo sapiens
PSA7L_HUMAN	proteasome subunit alpha 8(PSMA8)	Homo sapiens
KREM2_HUMAN	kringle containing transmembrane protein 2(KREMEN2)	Homo sapiens
TIGD1_HUMAN	tigger transposable element derived 1(TIGD1)	Homo sapiens
AN30A_HUMAN	ankyrin repeat domain 30A(ANKRD30A)	Homo sapiens
PTK7_HUMAN	protein tyrosine kinase 7 (inactive)(PTK7)	Homo sapiens
DJB11_HUMAN	DnaJ heat shock protein family (Hsp40) member B11(DNAJB11)	Homo sapiens
CO6A6_HUMAN	collagen type VI alpha 6 chain(COL6A6)	Homo sapiens
PTH2R_HUMAN	parathyroid hormone 2 receptor(PTH2R)	Homo sapiens
TRY2_HUMAN	protease, serine 2(PRSS2)	Homo sapiens
TRY1_HUMAN	protease, serine 1(PRSS1)	Homo sapiens
LGMN_HUMAN	legumain(LGMN)	Homo sapiens
G6PE_HUMAN	hexose-6-phosphate dehydrogenase/glucose 1-dehydrogenase(H6PD)	Homo sapiens
MINP1_HUMAN	multiple inositol-polyphosphate phosphatase 1(MINPP1)	Homo sapiens
KPRB_HUMAN	phosphoribosyl pyrophosphate synthetase associated protein 2(PRPSAP2)	Homo sapiens
PCDB2_HUMAN	protocadherin beta 2(PCDHB2)	Homo sapiens
PCDB4_HUMAN	protocadherin beta 4(PCDHB4)	Homo sapiens
LAC7_HUMAN	immunoglobulin lambda constant 7(IGLC7)	Homo sapiens
ECM2_HUMAN	extracellular matrix protein 2(ECM2)	Homo sapiens
PLGA_HUMAN	plasminogen-like A (pseudogene)(PLGLA)	Homo sapiens
SAP_HUMAN	prosaposin(PSAP)	Homo sapiens
S26A2_HUMAN	solute carrier family 26 member 2(SLC26A2)	Homo sapiens
DESP_HUMAN	desmoplakin(DSP)	Homo sapiens
TEX15_HUMAN	testis expressed 15(TEX15)	Homo sapiens
FBLN7_HUMAN	fibulin 7(FBLN7)	Homo sapiens
DSPP_HUMAN	dentin sialophosphoprotein(DSPP)	Homo sapiens
DSG2_HUMAN	desmoglein 2(DSG2)	Homo sapiens
NRG2_HUMAN	neuregulin 2(NRG2)	Homo sapiens
MASP1_HUMAN	mannan binding lectin serine peptidase 1(MASP1)	Homo sapiens
DSC2_HUMAN	desmocollin 2(DSC2)	Homo sapiens
RELN_HUMAN	reelin(RELN)	Homo sapiens
DSC3_HUMAN	desmocollin 3(DSC3)	Homo sapiens
GALT7_HUMAN	polypeptide N-acetylgalactosaminyltransferase 7(GALNT7)	Homo sapiens
DSC1_HUMAN	desmocollin 1(DSC1)	Homo sapiens
LEAP2_HUMAN	liver enriched antimicrobial peptide 2(LEAP2)	Homo sapiens
DYH7_HUMAN	dynein axonemal heavy chain 7(DNAH7)	Homo sapiens
LV301_HUMAN	immunoglobulin lambda variable 3-1(IGLV3-1)	Homo sapiens
A2GL_HUMAN	leucine rich alpha-2-glycoprotein 1(LRG1)	Homo sapiens
AKA12_HUMAN	A-kinase anchoring protein 12(AKAP12)	Homo sapiens
S26A3_HUMAN	solute carrier family 26 member 3(SLC26A3)	Homo sapiens
PSB6_HUMAN	proteasome subunit beta 6(PSMB6)	Homo sapiens
PSB4_HUMAN	proteasome subunit beta 4(PSMB4)	Homo sapiens
EPHA6_HUMAN	EPH receptor A6(EPHA6)	Homo sapiens
PSB2_HUMAN	proteasome subunit beta 2(PSMB2)	Homo sapiens
DPP4_HUMAN	dipeptidyl peptidase 4(DPP4)	Homo sapiens
PSA7_HUMAN	proteasome subunit alpha 7(PSMA7)	Homo sapiens
PSA5_HUMAN	proteasome subunit alpha 5(PSMA5)	Homo sapiens
PSA6_HUMAN	proteasome subunit alpha 6(PSMA6)	Homo sapiens
CLOCK_HUMAN	clock circadian regulator(CLOCK)	Homo sapiens
PSA4_HUMAN	proteasome subunit alpha 4(PSMA4)	Homo sapiens
PSA1_HUMAN	proteasome subunit alpha 1(PSMA1)	Homo sapiens
DOCK2_HUMAN	dedicator of cytokinesis 2(DOCK2)	Homo sapiens
PSA2_HUMAN	proteasome subunit alpha 2(PSMA2)	Homo sapiens
LV208_HUMAN	immunoglobulin lambda variable 2-8(IGLV2-8)	Homo sapiens
LV211_HUMAN	immunoglobulin lambda variable 2-11(IGLV2-11)	Homo sapiens
KI13A_HUMAN	kinesin family member 13A(KIF13A)	Homo sapiens
E41L1_HUMAN	erythrocyte membrane protein band 4.1 like 1(EPB41L1)	Homo sapiens
CCD60_HUMAN	coiled-coil domain containing 60(CCDC60)	Homo sapiens
E41L2_HUMAN	erythrocyte membrane protein band 4.1 like 2(EPB41L2)	Homo sapiens
EPHA1_HUMAN	EPH receptor A1(EPHA1)	Homo sapiens
EPHA4_HUMAN	EPH receptor A4(EPHA4)	Homo sapiens
PYGL_HUMAN	phosphorylase, glycogen, liver(PYGL)	Homo sapiens
PYGM_HUMAN	phosphorylase, glycogen, muscle(PYGM)	Homo sapiens
PDIA4_HUMAN	protein disulfide isomerase family A member 4(PDIA4)	Homo sapiens
PRA19_HUMAN	PRAME family member 19(PRAMEF19)	Homo sapiens
TGM3L_HUMAN	transglutaminase 6(TGM6)	Homo sapiens
ENOA_HUMAN	enolase 1(ENO1)	Homo sapiens
CR3L1_HUMAN	cAMP responsive element binding protein 3 like 1(CREB3L1)	Homo sapiens
RSPO4_HUMAN	R-spondin 4(RSPO4)	Homo sapiens
ENOB_HUMAN	enolase 3(ENO3)	Homo sapiens
ENOG_HUMAN	enolase 2(ENO2)	Homo sapiens
AMPE_HUMAN	glutamyl aminopeptidase(ENPEP)	Homo sapiens
T132D_HUMAN	transmembrane protein 132D(TMEM132D)	Homo sapiens
SNX19_HUMAN	sorting nexin 19(SNX19)	Homo sapiens
PZP_HUMAN	PZP, alpha-2-macroglobulin like(PZP)	Homo sapiens
U17L4_HUMAN	ubiquitin specific peptidase 17-like family member 4(USP17L4)	Homo sapiens
CP135_HUMAN	centrosomal protein 135(CEP135)	Homo sapiens
DC4L1_HUMAN	DDB1 and CUL4 associated factor 4 like 1(DCAF4L1)	Homo sapiens
SUSD2_HUMAN	sushi domain containing 2(SUSD2)	Homo sapiens
ZC3H6_HUMAN	zinc finger CCCH-type containing 6(ZC3H6)	Homo sapiens
ILEU_HUMAN	serpin family B member 1(SERPINB1)	Homo sapiens
LRIG3_HUMAN	leucine rich repeats and immunoglobulin like domains 3(LRIG3)	Homo sapiens
LRC14_HUMAN	leucine rich repeat containing 14(LRRC14)	Homo sapiens
GCC1_HUMAN	GRIP and coiled-coil domain containing 1(GCC1)	Homo sapiens
DEPD5_HUMAN	DEP domain containing 5(DEPDC5)	Homo sapiens
TTC13_HUMAN	tetratricopeptide repeat domain 13(TTC13)	Homo sapiens
N4BP1_HUMAN	NEDD4 binding protein 1(N4BP1)	Homo sapiens
WIPI3_HUMAN	WD repeat domain 45B(WDR45B)	Homo sapiens
IF4G1_HUMAN	eukaryotic translation initiation factor 4 gamma 1(EIF4G1)	Homo sapiens
IF4G2_HUMAN	eukaryotic translation initiation factor 4 gamma 2(EIF4G2)	Homo sapiens
QSOX1_HUMAN	quiescin sulfhydryl oxidase 1(QSOX1)	Homo sapiens
PTN2_HUMAN	protein tyrosine phosphatase, non-receptor type 2(PTPN2)	Homo sapiens
PTN9_HUMAN	protein tyrosine phosphatase, non-receptor type 9(PTPN9)	Homo sapiens
EGFR_HUMAN	epidermal growth factor receptor(EGFR)	Homo sapiens
PTN13_HUMAN	protein tyrosine phosphatase, non-receptor type 13(PTPN13)	Homo sapiens
MEGF9_HUMAN	multiple EGF like domains 9(MEGF9)	Homo sapiens
MEGF8_HUMAN	multiple EGF like domains 8(MEGF8)	Homo sapiens
PTPRD_HUMAN	protein tyrosine phosphatase, receptor type D(PTPRD)	Homo sapiens
GKN1_HUMAN	gastrokine 1(GKN1)	Homo sapiens
EFNA1_HUMAN	ephrin A1(EFNA1)	Homo sapiens
PTPR2_HUMAN	protein tyrosine phosphatase, receptor type N2(PTPRN2)	Homo sapiens
PTPRK_HUMAN	protein tyrosine phosphatase, receptor type K(PTPRK)	Homo sapiens
PTPRM_HUMAN	protein tyrosine phosphatase, receptor type M(PTPRM)	Homo sapiens
PTPRF_HUMAN	protein tyrosine phosphatase, receptor type F(PTPRF)	Homo sapiens
PTPRG_HUMAN	protein tyrosine phosphatase, receptor type G(PTPRG)	Homo sapiens
NAA16_HUMAN	N(alpha)-acetyltransferase 16, NatA auxiliary subunit(NAA16)	Homo sapiens
PTPRS_HUMAN	protein tyrosine phosphatase, receptor type S(PTPRS)	Homo sapiens
EFNA3_HUMAN	ephrin A3(EFNA3)	Homo sapiens
ESPL1_HUMAN	extra spindle pole bodies like 1, separase(ESPL1)	Homo sapiens
CROCC_HUMAN	ciliary rootlet coiled-coil, rootletin(CROCC)	Homo sapiens
ARAP2_HUMAN	ArfGAP with RhoGAP domain, ankyrin repeat and PH domain 2(ARAP2)	Homo sapiens
PVR_HUMAN	poliovirus receptor(PVR)	Homo sapiens
FBN1_HUMAN	fibrillin 1(FBN1)	Homo sapiens
ARHG3_HUMAN	Rho guanine nucleotide exchange factor 3(ARHGEF3)	Homo sapiens
ATL4_HUMAN	ADAMTS like 4(ADAMTSL4)	Homo sapiens
FBLN3_HUMAN	EGF containing fibulin like extracellular matrix protein 1(EFEMP1)	Homo sapiens
F16P1_HUMAN	fructose-bisphosphatase 1(FBP1)	Homo sapiens
ISK5_HUMAN	serine peptidase inhibitor, Kazal type 5(SPINK5)	Homo sapiens
SF3B2_HUMAN	splicing factor 3b subunit 2(SF3B2)	Homo sapiens
SYFA_HUMAN	phenylalanyl-tRNA synthetase alpha subunit(FARSA)	Homo sapiens
FAS_HUMAN	fatty acid synthase(FASN)	Homo sapiens
PLPL8_HUMAN	patatin like phospholipase domain containing 8(PNPLA8)	Homo sapiens
FAT1_HUMAN	FAT atypical cadherin 1(FAT1)	Homo sapiens
FAT2_HUMAN	FAT atypical cadherin 2(FAT2)	Homo sapiens
COSA1_HUMAN	collagen type XXVIII alpha 1 chain(COL28A1)	Homo sapiens
EDAD_HUMAN	EDAR associated death domain(EDARADD)	Homo sapiens
SPT21_HUMAN	spermatogenesis associated 21(SPATA21)	Homo sapiens
FBLN2_HUMAN	fibulin 2(FBLN2)	Homo sapiens
S27A4_HUMAN	solute carrier family 27 member 4(SLC27A4)	Homo sapiens
SLIT1_HUMAN	slit guidance ligand 1(SLIT1)	Homo sapiens
FAAA_HUMAN	fumarylacetoacetate hydrolase(FAH)	Homo sapiens
PPN_HUMAN	papilin, proteoglycan like sulfated glycoprotein(PAPLN)	Homo sapiens
BPTF_HUMAN	bromodomain PHD finger transcription factor(BPTF)	Homo sapiens
SEPR_HUMAN	fibroblast activation protein alpha(FAP)	Homo sapiens
LIRB5_HUMAN	leukocyte immunoglobulin like receptor B5(LILRB5)	Homo sapiens
FERM2_HUMAN	fermitin family member 2(FERMT2)	Homo sapiens
CCNI_HUMAN	cyclin I(CCNI)	Homo sapiens
S22A4_HUMAN	solute carrier family 22 member 4(SLC22A4)	Homo sapiens
RF1ML_HUMAN	mitochondrial translational release factor 1 like(MTRF1L)	Homo sapiens
1433T_HUMAN	tyrosine 3-monooxygenase/tryptophan 5-monooxygenase activation protein theta(YWHAQ)	Homo sapiens
K1C20_HUMAN	keratin 20(KRT20)	Homo sapiens
LPAL2_HUMAN	lipoprotein(a) like 2, pseudogene(LPAL2)	Homo sapiens
FEN1_HUMAN	flap structure-specific endonuclease 1(FEN1)	Homo sapiens
LMAN2_HUMAN	lectin, mannose binding 2(LMAN2)	Homo sapiens
FCN1_HUMAN	ficolin 1(FCN1)	Homo sapiens
TOM34_HUMAN	translocase of outer mitochondrial membrane 34(TOMM34)	Homo sapiens
FCN2_HUMAN	ficolin 2(FCN2)	Homo sapiens
ZN519_HUMAN	zinc finger protein 519(ZNF519)	Homo sapiens
CHPF2_HUMAN	chondroitin polymerizing factor 2(CHPF2)	Homo sapiens
FCER2_HUMAN	Fc fragment of IgE receptor II(FCER2)	Homo sapiens
FCG3B_HUMAN	Fc fragment of IgG receptor IIIb(FCGR3B)	Homo sapiens
ZEP3_HUMAN	human immunodeficiency virus type I enhancer binding protein 3(HIVEP3)	Homo sapiens
CEP70_HUMAN	centrosomal protein 70(CEP70)	Homo sapiens
FCG2C_HUMAN	Fc fragment of IgG receptor IIb(FCGR2B)	Homo sapiens
FCG2A_HUMAN	Fc fragment of IgG receptor IIa(FCGR2A)	Homo sapiens
POP1_HUMAN	POP1 homolog, ribonuclease P/MRP subunit(POP1)	Homo sapiens
UD2A1_HUMAN	UDP glucuronosyltransferase family 2 member A1 complex locus(UGT2A1)	Homo sapiens
TET1_HUMAN	tet methylcytosine dioxygenase 1(TET1)	Homo sapiens
FGFR4_HUMAN	fibroblast growth factor receptor 4(FGFR4)	Homo sapiens
FGFR1_HUMAN	fibroblast growth factor receptor 1(FGFR1)	Homo sapiens
FR1L4_HUMAN	fer-1 like family member 4, pseudogene(FER1L4)	Homo sapiens
S3TC1_HUMAN	SH3 domain and tetratricopeptide repeats 1(SH3TC1)	Homo sapiens
FGFR2_HUMAN	fibroblast growth factor receptor 2(FGFR2)	Homo sapiens
K1C28_HUMAN	keratin 28(KRT28)	Homo sapiens
RBP1_HUMAN	ralA binding protein 1(RALBP1)	Homo sapiens
ASM3A_HUMAN	sphingomyelin phosphodiesterase acid like 3A(SMPDL3A)	Homo sapiens
FGF9_HUMAN	fibroblast growth factor 9(FGF9)	Homo sapiens
SODE_HUMAN	superoxide dismutase 3, extracellular(SOD3)	Homo sapiens
SODM_HUMAN	superoxide dismutase 2, mitochondrial(SOD2)	Homo sapiens
IQGA3_HUMAN	IQ motif containing GTPase activating protein 3(IQGAP3)	Homo sapiens
FGD1_HUMAN	FYVE, RhoGEF and PH domain containing 1(FGD1)	Homo sapiens
ATD2B_HUMAN	ATPase family, AAA domain containing 2B(ATAD2B)	Homo sapiens
PEAR1_HUMAN	platelet endothelial aggregation receptor 1(PEAR1)	Homo sapiens
RIN2_HUMAN	Ras and Rab interactor 2(RIN2)	Homo sapiens
SODC_HUMAN	superoxide dismutase 1, soluble(SOD1)	Homo sapiens
FER_HUMAN	FER tyrosine kinase(FER)	Homo sapiens
MCM9_HUMAN	minichromosome maintenance 9 homologous recombination repair factor(MCM9)	Homo sapiens
FOXJ1_HUMAN	forkhead box J1(FOXJ1)	Homo sapiens
SMRD3_HUMAN	SWI/SNF related, matrix associated, actin dependent regulator of chromatin, subfamily d, member 3(SMARCD3)	Homo sapiens
U17L7_HUMAN	ubiquitin specific peptidase 17-like family member 7(USP17L7)	Homo sapiens
SMRC1_HUMAN	SWI/SNF related, matrix associated, actin dependent regulator of chromatin subfamily c member 1(SMARCC1)	Homo sapiens
IL21R_HUMAN	interleukin 21 receptor(IL21R)	Homo sapiens
SMCA1_HUMAN	SWI/SNF related, matrix associated, actin dependent regulator of chromatin, subfamily a, member 1(SMARCA1)	Homo sapiens
SCRT2_HUMAN	scratch family transcriptional repressor 2(SCRT2)	Homo sapiens
UBE3B_HUMAN	ubiquitin protein ligase E3B(UBE3B)	Homo sapiens
CK5P3_HUMAN	CDK5 regulatory subunit associated protein 3(CDK5RAP3)	Homo sapiens
ZDH24_HUMAN	zinc finger DHHC-type containing 24(ZDHHC24)	Homo sapiens
LYVE1_HUMAN	lymphatic vessel endothelial hyaluronan receptor 1(LYVE1)	Homo sapiens
IL20_HUMAN	interleukin 20(IL20)	Homo sapiens
MMP24_HUMAN	matrix metallopeptidase 24(MMP24)	Homo sapiens
TTC16_HUMAN	tetratricopeptide repeat domain 16(TTC16)	Homo sapiens
P2R3B_HUMAN	protein phosphatase 2 regulatory subunit B''beta(PPP2R3B)	Homo sapiens
RGDSR_HUMAN	ral guanine nucleotide dissociation stimulator like 4(RGL4)	Homo sapiens
ERBB4_HUMAN	erb-b2 receptor tyrosine kinase 4(ERBB4)	Homo sapiens
F198A_HUMAN	family with sequence similarity 198 member A(FAM198A)	Homo sapiens
GRPE2_HUMAN	GrpE like 2, mitochondrial(GRPEL2)	Homo sapiens
SFTPD_HUMAN	surfactant protein D(SFTPD)	Homo sapiens
CEP63_HUMAN	centrosomal protein 63(CEP63)	Homo sapiens
FGL2_HUMAN	fibrinogen like 2(FGL2)	Homo sapiens
ACTBL_HUMAN	actin, beta like 2(ACTBL2)	Homo sapiens
EP3A_HUMAN	epididymal protein 3A(EDDM3A)	Homo sapiens
SMR3B_HUMAN	submaxillary gland androgen regulated protein 3B(SMR3B)	Homo sapiens
FHR3_HUMAN	complement factor H related 3(CFHR3)	Homo sapiens
L37A3_HUMAN	leucine rich repeat containing 37 member A3(LRRC37A3)	Homo sapiens
TE2IP_HUMAN	TERF2 interacting protein(TERF2IP)	Homo sapiens
ITSN1_HUMAN	intersectin 1(ITSN1)	Homo sapiens
HPSE_HUMAN	heparanase(HPSE)	Homo sapiens
SYEP_HUMAN	glutamyl-prolyl-tRNA synthetase(EPRS)	Homo sapiens
LIRB1_HUMAN	leukocyte immunoglobulin like receptor B1(LILRB1)	Homo sapiens
SHBG_HUMAN	sex hormone binding globulin(SHBG)	Homo sapiens
LYAM3_HUMAN	selectin P(SELP)	Homo sapiens
ESTD_HUMAN	esterase D(ESD)	Homo sapiens
LYAM1_HUMAN	selectin L(SELL)	Homo sapiens
LYAM2_HUMAN	selectin E(SELE)	Homo sapiens
SPTCS_HUMAN	spastic paraplegia 11 (autosomal recessive)(SPG11)	Homo sapiens
SEM3F_HUMAN	semaphorin 3F(SEMA3F)	Homo sapiens
OR1K1_HUMAN	olfactory receptor family 1 subfamily K member 1(OR1K1)	Homo sapiens
ARMC9_HUMAN	armadillo repeat containing 9(ARMC9)	Homo sapiens
ERR3_HUMAN	estrogen related receptor gamma(ESRRG)	Homo sapiens
SRCAP_HUMAN	Snf2 related CREBBP activator protein(SRCAP)	Homo sapiens
SEPP1_HUMAN	selenoprotein P(SELENOP)	Homo sapiens
CAD20_HUMAN	cadherin 20(CDH20)	Homo sapiens
GCP2_HUMAN	tubulin gamma complex associated protein 2(TUBGCP2)	Homo sapiens
MUS81_HUMAN	MUS81 structure-specific endonuclease subunit(MUS81)	Homo sapiens
KV105_HUMAN	immunoglobulin kappa variable 1-5(IGKV1-5)	Homo sapiens
GDPD4_HUMAN	glycerophosphodiester phosphodiesterase domain containing 4(GDPD4)	Homo sapiens
SFRP4_HUMAN	secreted frizzled related protein 4(SFRP4)	Homo sapiens
NEUR3_HUMAN	neuraminidase 3(NEU3)	Homo sapiens
CEL2A_HUMAN	chymotrypsin like elastase family member 2A(CELA2A)	Homo sapiens
EXT2_HUMAN	exostosin glycosyltransferase 2(EXT2)	Homo sapiens
EXTL2_HUMAN	exostosin like glycosyltransferase 2(EXTL2)	Homo sapiens
EXT1_HUMAN	exostosin glycosyltransferase 1(EXT1)	Homo sapiens
CE290_HUMAN	centrosomal protein 290(CEP290)	Homo sapiens
IQGA2_HUMAN	IQ motif containing GTPase activating protein 2(IQGAP2)	Homo sapiens
SAMD3_HUMAN	sterile alpha motif domain containing 3(SAMD3)	Homo sapiens
B3GN8_HUMAN	UDP-GlcNAc:betaGal beta-1,3-N-acetylglucosaminyltransferase 8(B3GNT8)	Homo sapiens
K1C26_HUMAN	keratin 26(KRT26)	Homo sapiens
EAA5_HUMAN	solute carrier family 1 member 7(SLC1A7)	Homo sapiens
ETS1_HUMAN	ETS proto-oncogene 1, transcription factor(ETS1)	Homo sapiens
GTR2_HUMAN	solute carrier family 2 member 2(SLC2A2)	Homo sapiens
ETV1_HUMAN	ETS variant 1(ETV1)	Homo sapiens
SBSN_HUMAN	suprabasin(SBSN)	Homo sapiens
EVPL_HUMAN	envoplakin(EVPL)	Homo sapiens
4F2_HUMAN	solute carrier family 3 member 2(SLC3A2)	Homo sapiens
EVC_HUMAN	EvC ciliary complex subunit 1(EVC)	Homo sapiens
ZN460_HUMAN	zinc finger protein 460(ZNF460)	Homo sapiens
SC5A1_HUMAN	solute carrier family 5 member 1(SLC5A1)	Homo sapiens
IFT74_HUMAN	intraflagellar transport 74(IFT74)	Homo sapiens
FABP4_HUMAN	fatty acid binding protein 4(FABP4)	Homo sapiens
FRAS1_HUMAN	Fraser extracellular matrix complex subunit 1(FRAS1)	Homo sapiens
F13A_HUMAN	coagulation factor XIII A chain(F13A1)	Homo sapiens
AN30B_HUMAN	ankyrin repeat domain 30B(ANKRD30B)	Homo sapiens
FA11_HUMAN	coagulation factor XI(F11)	Homo sapiens
SAHH2_HUMAN	adenosylhomocysteinase like 1(AHCYL1)	Homo sapiens
SHC1_HUMAN	SHC adaptor protein 1(SHC1)	Homo sapiens
FANCA_HUMAN	Fanconi anemia complementation group A(FANCA)	Homo sapiens
ZN234_HUMAN	zinc finger protein 234(ZNF234)	Homo sapiens
FABPH_HUMAN	fatty acid binding protein 3(FABP3)	Homo sapiens
FABPL_HUMAN	fatty acid binding protein 1(FABP1)	Homo sapiens
CQ054_HUMAN	long intergenic non-protein coding RNA 469(LINC00469)	Homo sapiens
THRB_HUMAN	coagulation factor II, thrombin(F2)	Homo sapiens
NCHL1_HUMAN	cell adhesion molecule L1 like(CHL1)	Homo sapiens
FA9_HUMAN	coagulation factor IX(F9)	Homo sapiens
FA10_HUMAN	coagulation factor X(F10)	Homo sapiens
FA8_HUMAN	coagulation factor VIII(F8)	Homo sapiens
NUP50_HUMAN	nucleoporin 50(NUP50)	Homo sapiens
FA7_HUMAN	coagulation factor VII(F7)	Homo sapiens
FA5_HUMAN	coagulation factor V(F5)	Homo sapiens
SIA8A_HUMAN	ST8 alpha-N-acetyl-neuraminide alpha-2,8-sialyltransferase 1(ST8SIA1)	Homo sapiens
SIKE1_HUMAN	suppressor of IKBKE 1(SIKE1)	Homo sapiens
HV311_HUMAN	immunoglobulin heavy variable 3-11 (gene/pseudogene)(IGHV3-11)	Homo sapiens
HYDIN_HUMAN	HYDIN, axonemal central pair apparatus protein(HYDIN)	Homo sapiens
HPS5_HUMAN	HPS5, biogenesis of lysosomal organelles complex 2 subunit 2(HPS5)	Homo sapiens
HV309_HUMAN	immunoglobulin heavy variable 3-9(IGHV3-9)	Homo sapiens
HV313_HUMAN	immunoglobulin heavy variable 3-13(IGHV3-13)	Homo sapiens
O6C65_HUMAN	olfactory receptor family 6 subfamily C member 65(OR6C65)	Homo sapiens
SCN2A_HUMAN	sodium voltage-gated channel alpha subunit 2(SCN2A)	Homo sapiens
NOMO2_HUMAN	NODAL modulator 2(NOMO2)	Homo sapiens
HV307_HUMAN	immunoglobulin heavy variable 3-7(IGHV3-7)	Homo sapiens
RN139_HUMAN	ring finger protein 139(RNF139)	Homo sapiens
PAG15_HUMAN	phospholipase A2 group XV(PLA2G15)	Homo sapiens
FIL1L_HUMAN	filamin A interacting protein 1 like(FILIP1L)	Homo sapiens
UNC5B_HUMAN	unc-5 netrin receptor B(UNC5B)	Homo sapiens
FA20A_HUMAN	FAM20A, golgi associated secretory pathway pseudokinase(FAM20A)	Homo sapiens
PLXB2_HUMAN	plexin B2(PLXNB2)	Homo sapiens
PR15A_HUMAN	protein phosphatase 1 regulatory subunit 15A(PPP1R15A)	Homo sapiens
PLD3_HUMAN	phospholipase D family member 3(PLD3)	Homo sapiens
CU104_HUMAN	long intergenic non-protein coding RNA 527(LINC00527)	Homo sapiens
AKP13_HUMAN	A-kinase anchoring protein 13(AKAP13)	Homo sapiens
CCD15_HUMAN	coiled-coil domain containing 15(CCDC15)	Homo sapiens
SAA4_HUMAN	serum amyloid A4, constitutive(SAA4)	Homo sapiens
NUP62_HUMAN	nucleoporin 62(NUP62)	Homo sapiens
S10A9_HUMAN	S100 calcium binding protein A9(S100A9)	Homo sapiens
GALT6_HUMAN	polypeptide N-acetylgalactosaminyltransferase 6(GALNT6)	Homo sapiens
SPO11_HUMAN	SPO11, initiator of meiotic double stranded breaks(SPO11)	Homo sapiens
S10AC_HUMAN	S100 calcium binding protein A12(S100A12)	Homo sapiens
S100P_HUMAN	S100 calcium binding protein P(S100P)	Homo sapiens
TSSK2_HUMAN	testis specific serine kinase 2(TSSK2)	Homo sapiens
OTUD4_HUMAN	OTU deubiquitinase 4(OTUD4)	Homo sapiens
DUS10_HUMAN	dual specificity phosphatase 10(DUSP10)	Homo sapiens
S10A6_HUMAN	S100 calcium binding protein A6(S100A6)	Homo sapiens
S10A8_HUMAN	S100 calcium binding protein A8(S100A8)	Homo sapiens
TREA_HUMAN	trehalase(TREH)	Homo sapiens
ZN277_HUMAN	zinc finger protein 277(ZNF277)	Homo sapiens
FUCO2_HUMAN	fucosidase, alpha-L- 2, plasma(FUCA2)	Homo sapiens
FUCO_HUMAN	fucosidase, alpha-L- 1, tissue(FUCA1)	Homo sapiens
BORG4_HUMAN	CDC42 effector protein 4(CDC42EP4)	Homo sapiens
COR1A_HUMAN	coronin 1A(CORO1A)	Homo sapiens
MANS1_HUMAN	MANSC domain containing 1(MANSC1)	Homo sapiens
CCL16_HUMAN	C-C motif chemokine ligand 16(CCL16)	Homo sapiens
PCX2_HUMAN	pecanex homolog 2 (Drosophila)(PCNX2)	Homo sapiens
OCTC_HUMAN	carnitine O-octanoyltransferase(CROT)	Homo sapiens
CCL15_HUMAN	C-C motif chemokine ligand 15(CCL15)	Homo sapiens
CCL14_HUMAN	C-C motif chemokine ligand 14(CCL14)	Homo sapiens
GRB1L_HUMAN	growth regulation by estrogen in breast cancer 1 like(GREB1L)	Homo sapiens
CCL8_HUMAN	C-C motif chemokine ligand 8(CCL8)	Homo sapiens
CCL7_HUMAN	C-C motif chemokine ligand 7(CCL7)	Homo sapiens
NUDT3_HUMAN	nudix hydrolase 3(NUDT3)	Homo sapiens
GBRA5_HUMAN	gamma-aminobutyric acid type A receptor alpha5 subunit(GABRA5)	Homo sapiens
FSTL1_HUMAN	follistatin like 1(FSTL1)	Homo sapiens
SHRM1_HUMAN	shroom family member 1(SHROOM1)	Homo sapiens
SEM6D_HUMAN	semaphorin 6D(SEMA6D)	Homo sapiens
CCL2_HUMAN	C-C motif chemokine ligand 2(CCL2)	Homo sapiens
LYAG_HUMAN	glucosidase alpha, acid(GAA)	Homo sapiens
SCNAA_HUMAN	sodium voltage-gated channel alpha subunit 10(SCN10A)	Homo sapiens
TSN15_HUMAN	tetraspanin 15(TSPAN15)	Homo sapiens
TMM62_HUMAN	transmembrane protein 62(TMEM62)	Homo sapiens
NAV2_HUMAN	neuron navigator 2(NAV2)	Homo sapiens
FRMD1_HUMAN	FERM domain containing 1(FRMD1)	Homo sapiens
RS9_HUMAN	ribosomal protein S9(RPS9)	Homo sapiens
FILA_HUMAN	filaggrin(FLG)	Homo sapiens
FLNC_HUMAN	filamin C(FLNC)	Homo sapiens
FLNA_HUMAN	filamin A(FLNA)	Homo sapiens
FLNB_HUMAN	filamin B(FLNB)	Homo sapiens
PAR14_HUMAN	poly(ADP-ribose) polymerase family member 14(PARP14)	Homo sapiens
PKHH3_HUMAN	pleckstrin homology, MyTH4 and FERM domain containing H3(PLEKHH3)	Homo sapiens
SVEP1_HUMAN	sushi, von Willebrand factor type A, EGF and pentraxin domain containing 1(SVEP1)	Homo sapiens
VGFR3_HUMAN	fms related tyrosine kinase 4(FLT4)	Homo sapiens
FMOD_HUMAN	fibromodulin(FMOD)	Homo sapiens
FMO5_HUMAN	flavin containing monooxygenase 5(FMO5)	Homo sapiens
FMO4_HUMAN	flavin containing monooxygenase 4(FMO4)	Homo sapiens
FMO3_HUMAN	flavin containing monooxygenase 3(FMO3)	Homo sapiens
FINC_HUMAN	fibronectin 1(FN1)	Homo sapiens
CH034_HUMAN	chromosome 8 open reading frame 34(C8orf34)	Homo sapiens
PIPNB_HUMAN	phosphatidylinositol transfer protein beta(PITPNB)	Homo sapiens
STAC3_HUMAN	SH3 and cysteine rich domain 3(STAC3)	Homo sapiens
RL32_HUMAN	ribosomal protein L32(RPL32)	Homo sapiens
MAFF_HUMAN	MAF bZIP transcription factor F(MAFF)	Homo sapiens
HSF2B_HUMAN	heat shock transcription factor 2 binding protein(HSF2BP)	Homo sapiens
RHGBB_HUMAN	Rho GTPase activating protein 11B(ARHGAP11B)	Homo sapiens
RL38_HUMAN	ribosomal protein L38(RPL38)	Homo sapiens
DIDO1_HUMAN	death inducer-obliterator 1(DIDO1)	Homo sapiens
FOLR2_HUMAN	folate receptor beta(FOLR2)	Homo sapiens
EME1_HUMAN	essential meiotic structure-specific endonuclease 1(EME1)	Homo sapiens
NUDC2_HUMAN	NudC domain containing 2(NUDCD2)	Homo sapiens
ATS13_HUMAN	ADAM metallopeptidase with thrombospondin type 1 motif 13(ADAMTS13)	Homo sapiens
NUPL2_HUMAN	nucleoporin like 2(NUPL2)	Homo sapiens
RYR2_HUMAN	ryanodine receptor 2(RYR2)	Homo sapiens
RYR3_HUMAN	ryanodine receptor 3(RYR3)	Homo sapiens
RYR1_HUMAN	ryanodine receptor 1(RYR1)	Homo sapiens
HRC23_HUMAN	hect domain and RLD 2 pseudogene 3(HERC2P3)	Homo sapiens
TRIM1_HUMAN	midline 2(MID2)	Homo sapiens
LZTL1_HUMAN	leucine zipper transcription factor like 1(LZTFL1)	Homo sapiens
ACSM1_HUMAN	acyl-CoA synthetase medium-chain family member 1(ACSM1)	Homo sapiens
CB054_HUMAN	chromosome 2 open reading frame 54(C2orf54)	Homo sapiens
I23O2_HUMAN	indoleamine 2,3-dioxygenase 2(IDO2)	Homo sapiens
SPEF2_HUMAN	sperm flagellar 2(SPEF2)	Homo sapiens
TNIP3_HUMAN	TNFAIP3 interacting protein 3(TNIP3)	Homo sapiens
K319L_HUMAN	KIAA0319 like(KIAA0319L)	Homo sapiens
UBE2C_HUMAN	ubiquitin conjugating enzyme E2 C(UBE2C)	Homo sapiens
CLIP1_HUMAN	CAP-Gly domain containing linker protein 1(CLIP1)	Homo sapiens
UROL1_HUMAN	uromodulin like 1(UMODL1)	Homo sapiens
ZC3HE_HUMAN	zinc finger CCCH-type containing 14(ZC3H14)	Homo sapiens
RAB35_HUMAN	RAB35, member RAS oncogene family(RAB35)	Homo sapiens
TDRKH_HUMAN	tudor and KH domain containing(TDRKH)	Homo sapiens
CADM1_HUMAN	cell adhesion molecule 1(CADM1)	Homo sapiens
KCNE4_HUMAN	potassium voltage-gated channel subfamily E regulatory subunit 4(KCNE4)	Homo sapiens
GNL3L_HUMAN	G protein nucleolar 3 like(GNL3L)	Homo sapiens
HDA11_HUMAN	histone deacetylase 11(HDAC11)	Homo sapiens
UBP53_HUMAN	ubiquitin specific peptidase 53(USP53)	Homo sapiens
LIRA1_HUMAN	leukocyte immunoglobulin like receptor A1(LILRA1)	Homo sapiens
LIRA2_HUMAN	leukocyte immunoglobulin like receptor A2(LILRA2)	Homo sapiens
KPCD3_HUMAN	protein kinase D3(PRKD3)	Homo sapiens
LIRA3_HUMAN	leukocyte immunoglobulin like receptor A3(LILRA3)	Homo sapiens
ROBO4_HUMAN	roundabout guidance receptor 4(ROBO4)	Homo sapiens
EXOC6_HUMAN	exocyst complex component 6(EXOC6)	Homo sapiens
TY3H_HUMAN	tyrosine hydroxylase(TH)	Homo sapiens
MERTK_HUMAN	MER proto-oncogene, tyrosine kinase(MERTK)	Homo sapiens
TGM3_HUMAN	transglutaminase 3(TGM3)	Homo sapiens
GPNMB_HUMAN	glycoprotein nmb(GPNMB)	Homo sapiens
TGBR3_HUMAN	transforming growth factor beta receptor 3(TGFBR3)	Homo sapiens
DNJB8_HUMAN	DnaJ heat shock protein family (Hsp40) member B8(DNAJB8)	Homo sapiens
BGH3_HUMAN	transforming growth factor beta induced(TGFBI)	Homo sapiens
GLI2_HUMAN	GLI family zinc finger 2(GLI2)	Homo sapiens
TGFB1_HUMAN	transforming growth factor beta 1(TGFB1)	Homo sapiens
FAM3C_HUMAN	family with sequence similarity 3 member C(FAM3C)	Homo sapiens
PK1IP_HUMAN	PAK1 interacting protein 1(PAK1IP1)	Homo sapiens
U17L5_HUMAN	ubiquitin specific peptidase 17-like family member 5(USP17L5)	Homo sapiens
NAGPA_HUMAN	N-acetylglucosamine-1-phosphodiester alpha-N-acetylglucosaminidase(NAGPA)	Homo sapiens
APOL4_HUMAN	apolipoprotein L4(APOL4)	Homo sapiens
TSP4_HUMAN	thrombospondin 4(THBS4)	Homo sapiens
TSP3_HUMAN	thrombospondin 3(THBS3)	Homo sapiens
MYO15_HUMAN	myosin XVA(MYO15A)	Homo sapiens
TSP2_HUMAN	thrombospondin 2(THBS2)	Homo sapiens
TSP1_HUMAN	thrombospondin 1(THBS1)	Homo sapiens
TKT_HUMAN	transketolase(TKT)	Homo sapiens
GPC3_HUMAN	glypican 3(GPC3)	Homo sapiens
GLPK3_HUMAN	glycerol kinase 3 pseudogene(GK3P)	Homo sapiens
LRC41_HUMAN	leucine rich repeat containing 41(LRRC41)	Homo sapiens
SC23A_HUMAN	Sec23 homolog A, coat complex II component(SEC23A)	Homo sapiens
TIMP1_HUMAN	TIMP metallopeptidase inhibitor 1(TIMP1)	Homo sapiens
TIMP2_HUMAN	TIMP metallopeptidase inhibitor 2(TIMP2)	Homo sapiens
GLPK_HUMAN	glycerol kinase(GK)	Homo sapiens
ZPI_HUMAN	serpin family A member 10(SERPINA10)	Homo sapiens
TIA1_HUMAN	TIA1 cytotoxic granule associated RNA binding protein(TIA1)	Homo sapiens
HERC6_HUMAN	HECT and RLD domain containing E3 ubiquitin protein ligase family member 6(HERC6)	Homo sapiens
TIE1_HUMAN	tyrosine kinase with immunoglobulin like and EGF like domains 1(TIE1)	Homo sapiens
CCD40_HUMAN	coiled-coil domain containing 40(CCDC40)	Homo sapiens
SEC62_HUMAN	SEC62 homolog, preprotein translocation factor(SEC62)	Homo sapiens
IF_HUMAN	gastric intrinsic factor(GIF)	Homo sapiens
PIBF1_HUMAN	progesterone immunomodulatory binding factor 1(PIBF1)	Homo sapiens
GHR_HUMAN	growth hormone receptor(GHR)	Homo sapiens
1433S_HUMAN	stratifin(SFN)	Homo sapiens
GP1BA_HUMAN	glycoprotein Ib platelet alpha subunit(GP1BA)	Homo sapiens
RHG07_HUMAN	DLC1 Rho GTPase activating protein(DLC1)	Homo sapiens
LAP2A_HUMAN	thymopoietin(TMPO)	Homo sapiens
APC10_HUMAN	anaphase promoting complex subunit 10(ANAPC10)	Homo sapiens
R4RL2_HUMAN	reticulon 4 receptor-like 2(RTN4RL2)	Homo sapiens
IRAK4_HUMAN	interleukin 1 receptor associated kinase 4(IRAK4)	Homo sapiens
CLM9_HUMAN	CD300 molecule like family member g(CD300LG)	Homo sapiens
TMF1_HUMAN	TATA element modulatory factor 1(TMF1)	Homo sapiens
AATC_HUMAN	glutamic-oxaloacetic transaminase 1(GOT1)	Homo sapiens
TRI17_HUMAN	tripartite motif containing 17(TRIM17)	Homo sapiens
COIA1_HUMAN	collagen type XVIII alpha 1 chain(COL18A1)	Homo sapiens
COMD4_HUMAN	COMM domain containing 4(COMMD4)	Homo sapiens
RMD1_HUMAN	regulator of microtubule dynamics 1(RMDN1)	Homo sapiens
KCNV2_HUMAN	potassium voltage-gated channel modifier subfamily V member 2(KCNV2)	Homo sapiens
K1C24_HUMAN	keratin 24(KRT24)	Homo sapiens
SACA3_HUMAN	sperm acrosome associated 3(SPACA3)	Homo sapiens
TENXA_HUMAN	tenascin XA (pseudogene)(TNXA)	Homo sapiens
SC24B_HUMAN	SEC24 homolog B, COPII coat complex component(SEC24B)	Homo sapiens
GNAT2_HUMAN	G protein subunit alpha transducin 2(GNAT2)	Homo sapiens
PGAM4_HUMAN	phosphoglycerate mutase family member 4(PGAM4)	Homo sapiens
TENX_HUMAN	tenascin XB(TNXB)	Homo sapiens
POTEF_HUMAN	POTE ankyrin domain family member F(POTEF)	Homo sapiens
SPON1_HUMAN	spondin 1(SPON1)	Homo sapiens
K2C73_HUMAN	keratin 73(KRT73)	Homo sapiens
BASP1_HUMAN	brain abundant membrane attached signal protein 1(BASP1)	Homo sapiens
SAP3_HUMAN	GM2 ganglioside activator(GM2A)	Homo sapiens
GML_HUMAN	glycosylphosphatidylinositol anchored molecule like(GML)	Homo sapiens
TPD53_HUMAN	tumor protein D52-like 1(TPD52L1)	Homo sapiens
TPIS_HUMAN	triosephosphate isomerase 1(TPI1)	Homo sapiens
SIA10_HUMAN	ST3 beta-galactoside alpha-2,3-sialyltransferase 6(ST3GAL6)	Homo sapiens
RRAGB_HUMAN	Ras related GTP binding B(RRAGB)	Homo sapiens
THAS_HUMAN	thromboxane A synthase 1(TBXAS1)	Homo sapiens
ACD10_HUMAN	acyl-CoA dehydrogenase family member 10(ACAD10)	Homo sapiens
CRIS3_HUMAN	cysteine rich secretory protein 3(CRISP3)	Homo sapiens
SNRK_HUMAN	SNF related kinase(SNRK)	Homo sapiens
GAS6_HUMAN	growth arrest specific 6(GAS6)	Homo sapiens
DEOC_HUMAN	deoxyribose-phosphate aldolase(DERA)	Homo sapiens
PUR2_HUMAN	phosphoribosylglycinamide formyltransferase, phosphoribosylglycinamide synthetase, phosphoribosylaminoimidazole synthetase(GART)	Homo sapiens
TMEM5_HUMAN	transmembrane protein 5(TMEM5)	Homo sapiens
QRIC1_HUMAN	glutamine rich 1(QRICH1)	Homo sapiens
G3P_HUMAN	glyceraldehyde-3-phosphate dehydrogenase(GAPDH)	Homo sapiens
GPTC4_HUMAN	G-patch domain containing 4(GPATCH4)	Homo sapiens
CAMP1_HUMAN	calmodulin regulated spectrin associated protein 1(CAMSAP1)	Homo sapiens
QSOX2_HUMAN	quiescin sulfhydryl oxidase 2(QSOX2)	Homo sapiens
AQ12A_HUMAN	aquaporin 12A(AQP12A)	Homo sapiens
GAK_HUMAN	cyclin G associated kinase(GAK)	Homo sapiens
AN18B_HUMAN	ankyrin repeat domain 18B(ANKRD18B)	Homo sapiens
TCO2_HUMAN	transcobalamin 2(TCN2)	Homo sapiens
B4GN1_HUMAN	beta-1,4-N-acetyl-galactosaminyltransferase 1(B4GALNT1)	Homo sapiens
GALT2_HUMAN	polypeptide N-acetylgalactosaminyltransferase 2(GALNT2)	Homo sapiens
ITIH5_HUMAN	inter-alpha-trypsin inhibitor heavy chain family member 5(ITIH5)	Homo sapiens
CEL2B_HUMAN	chymotrypsin like elastase family member 2B(CELA2B)	Homo sapiens
TTC19_HUMAN	tetratricopeptide repeat domain 19(TTC19)	Homo sapiens
SEN2_HUMAN	tRNA splicing endonuclease subunit 2(TSEN2)	Homo sapiens
TSH2_HUMAN	teashirt zinc finger homeobox 2(TSHZ2)	Homo sapiens
ABCAA_HUMAN	ATP binding cassette subfamily A member 10(ABCA10)	Homo sapiens
CG062_HUMAN	chromosome 7 open reading frame 62(C7orf62)	Homo sapiens
ABCA9_HUMAN	ATP binding cassette subfamily A member 9(ABCA9)	Homo sapiens
ABCA8_HUMAN	ATP binding cassette subfamily A member 8(ABCA8)	Homo sapiens
CCL26_HUMAN	C-C motif chemokine ligand 26(CCL26)	Homo sapiens
MRP4_HUMAN	ATP binding cassette subfamily C member 4(ABCC4)	Homo sapiens
GGT1_HUMAN	gamma-glutamyltransferase 1(GGT1)	Homo sapiens
IGSF6_HUMAN	immunoglobulin superfamily member 6(IGSF6)	Homo sapiens
B4GT1_HUMAN	beta-1,4-galactosyltransferase 1(B4GALT1)	Homo sapiens
BNC2_HUMAN	basonuclin 2(BNC2)	Homo sapiens
DYH2_HUMAN	dynein axonemal heavy chain 2(DNAH2)	Homo sapiens
COQ6_HUMAN	coenzyme Q6, monooxygenase(COQ6)	Homo sapiens
MBTD1_HUMAN	mbt domain containing 1(MBTD1)	Homo sapiens
GEPH_HUMAN	gephyrin(GPHN)	Homo sapiens
RIM3C_HUMAN	RIMS binding protein 3C(RIMBP3C)	Homo sapiens
MOD5_HUMAN	tRNA isopentenyltransferase 1(TRIT1)	Homo sapiens
CNNM2_HUMAN	cyclin and CBS domain divalent metal cation transport mediator 2(CNNM2)	Homo sapiens
GDF8_HUMAN	myostatin(MSTN)	Homo sapiens
GDIB_HUMAN	GDP dissociation inhibitor 2(GDI2)	Homo sapiens
PRDX2_HUMAN	peroxiredoxin 2(PRDX2)	Homo sapiens
GFAP_HUMAN	glial fibrillary acidic protein(GFAP)	Homo sapiens
TEC_HUMAN	tec protein tyrosine kinase(TEC)	Homo sapiens
CDHR2_HUMAN	cadherin related family member 2(CDHR2)	Homo sapiens
TFAM_HUMAN	transcription factor A, mitochondrial(TFAM)	Homo sapiens
KTNB1_HUMAN	katanin regulatory subunit B1(KATNB1)	Homo sapiens
FSTL3_HUMAN	follistatin like 3(FSTL3)	Homo sapiens
STAG1_HUMAN	stromal antigen 1(STAG1)	Homo sapiens
ARHG8_HUMAN	neuroepithelial cell transforming 1(NET1)	Homo sapiens
BSPRY_HUMAN	B-box and SPRY domain containing(BSPRY)	Homo sapiens
MFSD6_HUMAN	major facilitator superfamily domain containing 6(MFSD6)	Homo sapiens
TFF3_HUMAN	trefoil factor 3(TFF3)	Homo sapiens
APTX_HUMAN	aprataxin(APTX)	Homo sapiens
TFPI1_HUMAN	tissue factor pathway inhibitor(TFPI)	Homo sapiens
VTDB_HUMAN	GC, vitamin D binding protein(GC)	Homo sapiens
THYG_HUMAN	thyroglobulin(TG)	Homo sapiens
KIF19_HUMAN	kinesin family member 19(KIF19)	Homo sapiens
GUC2A_HUMAN	guanylate cyclase activator 2A(GUCA2A)	Homo sapiens
CNPY3_HUMAN	canopy FGF signaling regulator 3(CNPY3)	Homo sapiens
TCPQ_HUMAN	chaperonin containing TCP1 subunit 8(CCT8)	Homo sapiens
ZN462_HUMAN	zinc finger protein 462(ZNF462)	Homo sapiens
SRCRL_HUMAN	scavenger receptor cysteine rich family member with 5 domains(SSC5D)	Homo sapiens
H10_HUMAN	H1 histone family member 0(H1F0)	Homo sapiens
CP071_HUMAN	chromosome 16 open reading frame 71(C16orf71)	Homo sapiens
PDE11_HUMAN	phosphodiesterase 11A(PDE11A)	Homo sapiens
STK11_HUMAN	serine/threonine kinase 11(STK11)	Homo sapiens
CDON_HUMAN	cell adhesion associated, oncogene regulated(CDON)	Homo sapiens
AURKC_HUMAN	aurora kinase C(AURKC)	Homo sapiens
UBA6_HUMAN	ubiquitin like modifier activating enzyme 6(UBA6)	Homo sapiens
GRAH_HUMAN	granzyme H(GZMH)	Homo sapiens
RBM25_HUMAN	RNA binding motif protein 25(RBM25)	Homo sapiens
CTHR1_HUMAN	collagen triple helix repeat containing 1(CTHRC1)	Homo sapiens
NEK4_HUMAN	NIMA related kinase 4(NEK4)	Homo sapiens
SYCP1_HUMAN	synaptonemal complex protein 1(SYCP1)	Homo sapiens
VAMP1_HUMAN	vesicle associated membrane protein 1(VAMP1)	Homo sapiens
MAAI_HUMAN	glutathione S-transferase zeta 1(GSTZ1)	Homo sapiens
SVIL_HUMAN	supervillin(SVIL)	Homo sapiens
SURF6_HUMAN	surfeit 6(SURF6)	Homo sapiens
TRIM5_HUMAN	tripartite motif containing 5(TRIM5)	Homo sapiens
ABCC8_HUMAN	ATP binding cassette subfamily C member 8(ABCC8)	Homo sapiens
TF3C1_HUMAN	general transcription factor IIIC subunit 1(GTF3C1)	Homo sapiens
MASP2_HUMAN	mannan binding lectin serine peptidase 2(MASP2)	Homo sapiens
CC151_HUMAN	coiled-coil domain containing 151(CCDC151)	Homo sapiens
GTF2I_HUMAN	general transcription factor IIi(GTF2I)	Homo sapiens
ACRC_HUMAN	acidic repeat containing(ACRC)	Homo sapiens
HORN_HUMAN	hornerin(HRNR)	Homo sapiens
RSLAA_HUMAN	RAS like family 10 member A(RASL10A)	Homo sapiens
HBG2_HUMAN	hemoglobin subunit gamma 2(HBG2)	Homo sapiens
HEP2_HUMAN	serpin family D member 1(SERPIND1)	Homo sapiens
HBB_HUMAN	hemoglobin subunit beta(HBB)	Homo sapiens
ADAL_HUMAN	adenosine deaminase like(ADAL)	Homo sapiens
HBD_HUMAN	hemoglobin subunit delta(HBD)	Homo sapiens
HBG1_HUMAN	hemoglobin subunit gamma 1(HBG1)	Homo sapiens
VILL_HUMAN	villin like(VILL)	Homo sapiens
POSTN_HUMAN	periostin(POSTN)	Homo sapiens
CHADL_HUMAN	chondroadherin like(CHADL)	Homo sapiens
S61A2_HUMAN	Sec61 translocon alpha 2 subunit(SEC61A2)	Homo sapiens
RN220_HUMAN	ring finger protein 220(RNF220)	Homo sapiens
LIRB3_HUMAN	leukocyte immunoglobulin-like receptor subfamily B member 3(LOC102725035)	Homo sapiens
NCKPL_HUMAN	NCK associated protein 1 like(NCKAP1L)	Homo sapiens
IF2B2_HUMAN	insulin like growth factor 2 mRNA binding protein 2(IGF2BP2)	Homo sapiens
INT10_HUMAN	integrator complex subunit 10(INTS10)	Homo sapiens
SYN2_HUMAN	synapsin II(SYN2)	Homo sapiens
RAVR2_HUMAN	ribonucleoprotein, PTB binding 2(RAVER2)	Homo sapiens
THBG_HUMAN	serpin family A member 7(SERPINA7)	Homo sapiens
RRAGA_HUMAN	Ras related GTP binding A(RRAGA)	Homo sapiens
TA2R3_HUMAN	taste 2 receptor member 3(TAS2R3)	Homo sapiens
ZCH16_HUMAN	zinc finger CCHC-type containing 16(ZCCHC16)	Homo sapiens
CORA1_HUMAN	collagen type XXVII alpha 1 chain(COL27A1)	Homo sapiens
MACOI_HUMAN	transmembrane protein 57(TMEM57)	Homo sapiens
ZPBP2_HUMAN	zona pellucida binding protein 2(ZPBP2)	Homo sapiens
TALDO_HUMAN	transaldolase 1(TALDO1)	Homo sapiens
EXD1_HUMAN	exonuclease 3'-5' domain containing 1(EXD1)	Homo sapiens
ZBT8B_HUMAN	zinc finger and BTB domain containing 8B(ZBTB8B)	Homo sapiens
MUC16_HUMAN	mucin 16, cell surface associated(MUC16)	Homo sapiens
ZFP82_HUMAN	ZFP82 zinc finger protein(ZFP82)	Homo sapiens
HBA_HUMAN	hemoglobin subunit alpha 1(HBA1)	Homo sapiens
FANCI_HUMAN	Fanconi anemia complementation group I(FANCI)	Homo sapiens
PKHG6_HUMAN	pleckstrin homology and RhoGEF domain containing G6(PLEKHG6)	Homo sapiens
HABP2_HUMAN	hyaluronan binding protein 2(HABP2)	Homo sapiens
AGRIN_HUMAN	agrin(AGRN)	Homo sapiens
TN13B_HUMAN	tumor necrosis factor superfamily member 13b(TNFSF13B)	Homo sapiens
LGI2_HUMAN	leucine rich repeat LGI family member 2(LGI2)	Homo sapiens
B3GN2_HUMAN	UDP-GlcNAc:betaGal beta-1,3-N-acetylglucosaminyltransferase 2(B3GNT2)	Homo sapiens
AVIL_HUMAN	advillin(AVIL)	Homo sapiens
SPAG4_HUMAN	sperm associated antigen 4(SPAG4)	Homo sapiens
SPRC_HUMAN	secreted protein acidic and cysteine rich(SPARC)	Homo sapiens
PIWL2_HUMAN	piwi like RNA-mediated gene silencing 2(PIWIL2)	Homo sapiens
RHG12_HUMAN	Rho GTPase activating protein 12(ARHGAP12)	Homo sapiens
Z518B_HUMAN	zinc finger protein 518B(ZNF518B)	Homo sapiens
RP1L1_HUMAN	retinitis pigmentosa 1 like 1(RP1L1)	Homo sapiens
VKIND_HUMAN	kinase non-catalytic C-lobe domain containing 1(KNDC1)	Homo sapiens
GRK4_HUMAN	G protein-coupled receptor kinase 4(GRK4)	Homo sapiens
DOCK7_HUMAN	dedicator of cytokinesis 7(DOCK7)	Homo sapiens
MYEF2_HUMAN	myelin expression factor 2(MYEF2)	Homo sapiens
NPC2_HUMAN	NPC intracellular cholesterol transporter 2(NPC2)	Homo sapiens
LRCC1_HUMAN	leucine rich repeat and coiled-coil centrosomal protein 1(LRRCC1)	Homo sapiens
CNTP4_HUMAN	contactin associated protein like 4(CNTNAP4)	Homo sapiens
CRAC1_HUMAN	cartilage acidic protein 1(CRTAC1)	Homo sapiens
SAM9L_HUMAN	sterile alpha motif domain containing 9 like(SAMD9L)	Homo sapiens
GPX3_HUMAN	glutathione peroxidase 3(GPX3)	Homo sapiens
CSN1_HUMAN	G protein pathway suppressor 1(GPS1)	Homo sapiens
COL10_HUMAN	collectin subfamily member 10(COLEC10)	Homo sapiens
MKNK2_HUMAN	MAP kinase interacting serine/threonine kinase 2(MKNK2)	Homo sapiens
ALAT1_HUMAN	glutamic--pyruvic transaminase(GPT)	Homo sapiens
SPTB1_HUMAN	spectrin beta, erythrocytic(SPTB)	Homo sapiens
S26A5_HUMAN	solute carrier family 26 member 5(SLC26A5)	Homo sapiens
PHLD_HUMAN	glycosylphosphatidylinositol specific phospholipase D1(GPLD1)	Homo sapiens
SPTB2_HUMAN	spectrin beta, non-erythrocytic 1(SPTBN1)	Homo sapiens
SPTA1_HUMAN	spectrin alpha, erythrocytic 1(SPTA1)	Homo sapiens
G6PI_HUMAN	glucose-6-phosphate isomerase(GPI)	Homo sapiens
RASEF_HUMAN	RAS and EF-hand domain containing(RASEF)	Homo sapiens
GPDA_HUMAN	glycerol-3-phosphate dehydrogenase 1(GPD1)	Homo sapiens
SMC2_HUMAN	structural maintenance of chromosomes 2(SMC2)	Homo sapiens
SPTN2_HUMAN	spectrin beta, non-erythrocytic 2(SPTBN2)	Homo sapiens
UBP16_HUMAN	ubiquitin specific peptidase 16(USP16)	Homo sapiens
SPAG5_HUMAN	sperm associated antigen 5(SPAG5)	Homo sapiens
SPP24_HUMAN	secreted phosphoprotein 2(SPP2)	Homo sapiens
SFXN1_HUMAN	sideroflexin 1(SFXN1)	Homo sapiens
SPIT1_HUMAN	serine peptidase inhibitor, Kunitz type 1(SPINT1)	Homo sapiens
TRIM3_HUMAN	tripartite motif containing 3(TRIM3)	Homo sapiens
ADSV_HUMAN	scinderin(SCIN)	Homo sapiens
LRC8D_HUMAN	leucine rich repeat containing 8 family member D(LRRC8D)	Homo sapiens
OSTP_HUMAN	secreted phosphoprotein 1(SPP1)	Homo sapiens
RO60_HUMAN	TROVE domain family member 2(TROVE2)	Homo sapiens
CARM1_HUMAN	coactivator associated arginine methyltransferase 1(CARM1)	Homo sapiens
GRM4_HUMAN	glutamate metabotropic receptor 4(GRM4)	Homo sapiens
HSF5_HUMAN	heat shock transcription factor 5(HSF5)	Homo sapiens
GRM7_HUMAN	glutamate metabotropic receptor 7(GRM7)	Homo sapiens
GRM8_HUMAN	glutamate metabotropic receptor 8(GRM8)	Homo sapiens
CXCL2_HUMAN	C-X-C motif chemokine ligand 2(CXCL2)	Homo sapiens
DJC14_HUMAN	DnaJ heat shock protein family (Hsp40) member C14(DNAJC14)	Homo sapiens
CXCL3_HUMAN	C-X-C motif chemokine ligand 3(CXCL3)	Homo sapiens
SEM4D_HUMAN	semaphorin 4D(SEMA4D)	Homo sapiens
PDIA3_HUMAN	protein disulfide isomerase family A member 3(PDIA3)	Homo sapiens
SEM4B_HUMAN	semaphorin 4B(SEMA4B)	Homo sapiens
GRSF1_HUMAN	G-rich RNA sequence binding factor 1(GRSF1)	Homo sapiens
SRBP2_HUMAN	sterol regulatory element binding transcription factor 2(SREBF2)	Homo sapiens
K1671_HUMAN	KIAA1671(KIAA1671)	Homo sapiens
RIM3A_HUMAN	RIMS binding protein 3(RIMBP3)	Homo sapiens
GELS_HUMAN	gelsolin(GSN)	Homo sapiens
GSHB_HUMAN	glutathione synthetase(GSS)	Homo sapiens
SRP72_HUMAN	signal recognition particle 72(SRP72)	Homo sapiens
GSTA2_HUMAN	glutathione S-transferase alpha 2(GSTA2)	Homo sapiens
GSTA1_HUMAN	glutathione S-transferase alpha 1(GSTA1)	Homo sapiens
HYOU1_HUMAN	hypoxia up-regulated 1(HYOU1)	Homo sapiens
GPX5_HUMAN	glutathione peroxidase 5(GPX5)	Homo sapiens
STXB5_HUMAN	syntaxin binding protein 5(STXBP5)	Homo sapiens
MAGD4_HUMAN	MAGE family member D4(MAGED4)	Homo sapiens
ATG7_HUMAN	autophagy related 7(ATG7)	Homo sapiens
GRIA1_HUMAN	glutamate ionotropic receptor AMPA type subunit 1(GRIA1)	Homo sapiens
TM201_HUMAN	transmembrane protein 201(TMEM201)	Homo sapiens
STAT_HUMAN	statherin(STATH)	Homo sapiens
STA5A_HUMAN	signal transducer and activator of transcription 5A(STAT5A)	Homo sapiens
DCTN2_HUMAN	dynactin subunit 2(DCTN2)	Homo sapiens
ASB15_HUMAN	ankyrin repeat and SOCS box containing 15(ASB15)	Homo sapiens
EPCR_HUMAN	protein C receptor(PROCR)	Homo sapiens
KI26B_HUMAN	kinesin family member 26B(KIF26B)	Homo sapiens
GRM1_HUMAN	glutamate metabotropic receptor 1(GRM1)	Homo sapiens
RPP38_HUMAN	ribonuclease P/MRP subunit p38(RPP38)	Homo sapiens
DI3L1_HUMAN	DIS3 like exosome 3'-5' exoribonuclease(DIS3L)	Homo sapiens
DHB1_HUMAN	hydroxysteroid 17-beta dehydrogenase 1(HSD17B1)	Homo sapiens
DHB4_HUMAN	hydroxysteroid 17-beta dehydrogenase 4(HSD17B4)	Homo sapiens
OVCH1_HUMAN	ovochymase 1(OVCH1)	Homo sapiens
HS12A_HUMAN	heat shock protein family A (Hsp70) member 12A(HSPA12A)	Homo sapiens
UBFL6_HUMAN	upstream binding transcription factor, RNA polymerase I-like 6 (pseudogene)(UBTFL6)	Homo sapiens
ARFP1_HUMAN	ADP ribosylation factor interacting protein 1(ARFIP1)	Homo sapiens
CO041_HUMAN	chromosome 15 open reading frame 41(C15orf41)	Homo sapiens
JHD2C_HUMAN	jumonji domain containing 1C(JMJD1C)	Homo sapiens
FRPD1_HUMAN	FERM and PDZ domain containing 1(FRMPD1)	Homo sapiens
HRG_HUMAN	histidine rich glycoprotein(HRG)	Homo sapiens
K1841_HUMAN	KIAA1841(KIAA1841)	Homo sapiens
TNR21_HUMAN	TNF receptor superfamily member 21(TNFRSF21)	Homo sapiens
TMPS7_HUMAN	transmembrane protease, serine 7(TMPRSS7)	Homo sapiens
CJ131_HUMAN	chromosome 10 open reading frame 131(C10orf131)	Homo sapiens
HSP7C_HUMAN	heat shock protein family A (Hsp70) member 8(HSPA8)	Homo sapiens
HS90B_HUMAN	heat shock protein 90 alpha family class B member 1(HSP90AB1)	Homo sapiens
H90B3_HUMAN	heat shock protein 90 alpha family class B member 3, pseudogene(HSP90AB3P)	Homo sapiens
HS902_HUMAN	heat shock protein 90 alpha family class A member 2, pseudogene(HSP90AA2P)	Homo sapiens
TFEC_HUMAN	transcription factor EC(TFEC)	Homo sapiens
ZN75A_HUMAN	zinc finger protein 75a(ZNF75A)	Homo sapiens
HS90A_HUMAN	heat shock protein 90 alpha family class A member 1(HSP90AA1)	Homo sapiens
TDRD5_HUMAN	tudor domain containing 5(TDRD5)	Homo sapiens
F120B_HUMAN	family with sequence similarity 120B(FAM120B)	Homo sapiens
XRN2_HUMAN	5'-3' exoribonuclease 2(XRN2)	Homo sapiens
HSP77_HUMAN	heat shock protein family A (Hsp70) member 7(HSPA7)	Homo sapiens
HSP76_HUMAN	heat shock protein family A (Hsp70) member 6(HSPA6)	Homo sapiens
GRP78_HUMAN	heat shock protein family A (Hsp70) member 5(HSPA5)	Homo sapiens
HS71L_HUMAN	heat shock protein family A (Hsp70) member 1 like(HSPA1L)	Homo sapiens
NALCN_HUMAN	sodium leak channel, non-selective(NALCN)	Homo sapiens
CSTN1_HUMAN	calsyntenin 1(CLSTN1)	Homo sapiens
HXC10_HUMAN	homeobox C10(HOXC10)	Homo sapiens
P12LL_HUMAN	POM121 membrane glycoprotein (rat) pseudogene(LOC441081)	Homo sapiens
RRP44_HUMAN	DIS3 homolog, exosome endoribonuclease and 3'-5' exoribonuclease(DIS3)	Homo sapiens
DEND3_HUMAN	DENN domain containing 3(DENND3)	Homo sapiens
RUFY3_HUMAN	RUN and FYVE domain containing 3(RUFY3)	Homo sapiens
HXB3_HUMAN	homeobox B3(HOXB3)	Homo sapiens
HPTR_HUMAN	haptoglobin-related protein(HPR)	Homo sapiens
HPRT_HUMAN	hypoxanthine phosphoribosyltransferase 1(HPRT1)	Homo sapiens
HEPS_HUMAN	hepsin(HPN)	Homo sapiens
LMTK2_HUMAN	lemur tyrosine kinase 2(LMTK2)	Homo sapiens
ANR26_HUMAN	ankyrin repeat domain 26(ANKRD26)	Homo sapiens
HEMO_HUMAN	hemopexin(HPX)	Homo sapiens
OVCH2_HUMAN	ovochymase 2 (gene/pseudogene)(OVCH2)	Homo sapiens
HXD3_HUMAN	homeobox D3(HOXD3)	Homo sapiens
SLIK3_HUMAN	SLIT and NTRK like family member 3(SLITRK3)	Homo sapiens
PKHA6_HUMAN	pleckstrin homology domain containing A6(PLEKHA6)	Homo sapiens
GNPTG_HUMAN	N-acetylglucosamine-1-phosphate transferase gamma subunit(GNPTG)	Homo sapiens
CPMD8_HUMAN	C3 and PZP like, alpha-2-macroglobulin domain containing 8(CPAMD8)	Homo sapiens
SAC2_HUMAN	inositol polyphosphate-5-phosphatase F(INPP5F)	Homo sapiens
1433G_HUMAN	tyrosine 3-monooxygenase/tryptophan 5-monooxygenase activation protein gamma(YWHAG)	Homo sapiens
HMMR_HUMAN	hyaluronan mediated motility receptor(HMMR)	Homo sapiens
1433B_HUMAN	tyrosine 3-monooxygenase/tryptophan 5-monooxygenase activation protein beta(YWHAB)	Homo sapiens
1433E_HUMAN	tyrosine 3-monooxygenase/tryptophan 5-monooxygenase activation protein epsilon(YWHAE)	Homo sapiens
NADAP_HUMAN	solute carrier family 4 member 1 adaptor protein(SLC4A1AP)	Homo sapiens
SRR1L_HUMAN	SRR1 domain containing(SRRD)	Homo sapiens
ZIC2_HUMAN	Zic family member 2(ZIC2)	Homo sapiens
ZIC3_HUMAN	Zic family member 3(ZIC3)	Homo sapiens
GPAT2_HUMAN	glycerol-3-phosphate acyltransferase 2, mitochondrial(GPAT2)	Homo sapiens
GLYR1_HUMAN	glyoxylate reductase 1 homolog(GLYR1)	Homo sapiens
HLAH_HUMAN	major histocompatibility complex, class I, H (pseudogene)(HLA-H)	Homo sapiens
ATF6A_HUMAN	activating transcription factor 6(ATF6)	Homo sapiens
SGSM3_HUMAN	small G protein signaling modulator 3(SGSM3)	Homo sapiens
KIRR3_HUMAN	kin of IRRE like 3 (Drosophila)(KIRREL3)	Homo sapiens
C1QR1_HUMAN	CD93 molecule(CD93)	Homo sapiens
HNRPK_HUMAN	heterogeneous nuclear ribonucleoprotein K(HNRNPK)	Homo sapiens
HNRH2_HUMAN	heterogeneous nuclear ribonucleoprotein H2 (H')(HNRNPH2)	Homo sapiens
JKIP3_HUMAN	Janus kinase and microtubule interacting protein 3(JAKMIP3)	Homo sapiens
MMRN1_HUMAN	multimerin 1(MMRN1)	Homo sapiens
PCSK1_HUMAN	proprotein convertase subtilisin/kexin type 1 inhibitor(PCSK1N)	Homo sapiens
SHAN2_HUMAN	SH3 and multiple ankyrin repeat domains 2(SHANK2)	Homo sapiens
XPO1_HUMAN	exportin 1(XPO1)	Homo sapiens
PWP2_HUMAN	periodic tryptophan protein 2 homolog(LOC102724159)	Homo sapiens
XPP2_HUMAN	X-prolyl aminopeptidase 2(XPNPEP2)	Homo sapiens
KRBA1_HUMAN	KRAB-A domain containing 1(KRBA1)	Homo sapiens
ZN638_HUMAN	zinc finger protein 638(ZNF638)	Homo sapiens
RAB18_HUMAN	RAB18, member RAS oncogene family(RAB18)	Homo sapiens
TNC18_HUMAN	trinucleotide repeat containing 18(TNRC18)	Homo sapiens
SLIK2_HUMAN	SLIT and NTRK like family member 2(SLITRK2)	Homo sapiens
ANGL3_HUMAN	angiopoietin like 3(ANGPTL3)	Homo sapiens
TTBK1_HUMAN	tau tubulin kinase 1(TTBK1)	Homo sapiens
LRP1B_HUMAN	LDL receptor related protein 1B(LRP1B)	Homo sapiens
SHC3_HUMAN	SHC adaptor protein 3(SHC3)	Homo sapiens
PALLD_HUMAN	palladin, cytoskeletal associated protein(PALLD)	Homo sapiens
TNR6A_HUMAN	trinucleotide repeat containing 6A(TNRC6A)	Homo sapiens
ALAT2_HUMAN	glutamic--pyruvic transaminase 2(GPT2)	Homo sapiens
OR6C4_HUMAN	olfactory receptor family 6 subfamily C member 4(OR6C4)	Homo sapiens
FHR2_HUMAN	complement factor H related 2(CFHR2)	Homo sapiens
WN10B_HUMAN	Wnt family member 10B(WNT10B)	Homo sapiens
DOP1_HUMAN	dopey family member 1(DOPEY1)	Homo sapiens
CNDP1_HUMAN	carnosine dipeptidase 1(CNDP1)	Homo sapiens
HGFA_HUMAN	HGF activator(HGFAC)	Homo sapiens
WNT9B_HUMAN	Wnt family member 9B(WNT9B)	Homo sapiens
UN13A_HUMAN	unc-13 homolog A(UNC13A)	Homo sapiens
HEXA_HUMAN	hexosaminidase subunit alpha(HEXA)	Homo sapiens
HEXB_HUMAN	hexosaminidase subunit beta(HEXB)	Homo sapiens
ADEC1_HUMAN	ADAM like decysin 1(ADAMDEC1)	Homo sapiens
CFAH_HUMAN	complement factor H(CFH)	Homo sapiens
FHR1_HUMAN	complement factor H related 1(CFHR1)	Homo sapiens
OTOAN_HUMAN	otoancorin(OTOA)	Homo sapiens
HLAF_HUMAN	major histocompatibility complex, class I, F(HLA-F)	Homo sapiens
HLAE_HUMAN	major histocompatibility complex, class I, E(HLA-E)	Homo sapiens
VWA3A_HUMAN	von Willebrand factor A domain containing 3A(VWA3A)	Homo sapiens
MYH15_HUMAN	myosin heavy chain 15(MYH15)	Homo sapiens
VIME_HUMAN	vimentin(VIM)	Homo sapiens
SRPX2_HUMAN	sushi repeat containing protein, X-linked 2(SRPX2)	Homo sapiens
EZRI_HUMAN	ezrin(EZR)	Homo sapiens
MAST1_HUMAN	microtubule associated serine/threonine kinase 1(MAST1)	Homo sapiens
ST1B1_HUMAN	sulfotransferase family 1B member 1(SULT1B1)	Homo sapiens
ACTBM_HUMAN	POTE ankyrin domain family member K, pseudogene(POTEKP)	Homo sapiens
VWF_HUMAN	von Willebrand factor(VWF)	Homo sapiens
ZFP90_HUMAN	ZFP90 zinc finger protein(ZFP90)	Homo sapiens
HCN1_HUMAN	hyperpolarization activated cyclic nucleotide gated potassium channel 1(HCN1)	Homo sapiens
VTNC_HUMAN	vitronectin(VTN)	Homo sapiens
ZN746_HUMAN	zinc finger protein 746(ZNF746)	Homo sapiens
PLCH1_HUMAN	phospholipase C eta 1(PLCH1)	Homo sapiens
SYWC_HUMAN	tryptophanyl-tRNA synthetase(WARS)	Homo sapiens
1B15_HUMAN	major histocompatibility complex, class I, B(HLA-B)	Homo sapiens
1B82_HUMAN	major histocompatibility complex, class I, B(HLA-B)	Homo sapiens
1B08_HUMAN	major histocompatibility complex, class I, B(HLA-B)	Homo sapiens
1B47_HUMAN	major histocompatibility complex, class I, B(HLA-B)	Homo sapiens
1B51_HUMAN	major histocompatibility complex, class I, B(HLA-B)	Homo sapiens
1B59_HUMAN	major histocompatibility complex, class I, B(HLA-B)	Homo sapiens
1B48_HUMAN	major histocompatibility complex, class I, B(HLA-B)	Homo sapiens
1B35_HUMAN	major histocompatibility complex, class I, B(HLA-B)	Homo sapiens
1B44_HUMAN	major histocompatibility complex, class I, B(HLA-B)	Homo sapiens
1B81_HUMAN	major histocompatibility complex, class I, B(HLA-B)	Homo sapiens
1B49_HUMAN	major histocompatibility complex, class I, B(HLA-B)	Homo sapiens
1B42_HUMAN	major histocompatibility complex, class I, B(HLA-B)	Homo sapiens
1B54_HUMAN	major histocompatibility complex, class I, B(HLA-B)	Homo sapiens
1B52_HUMAN	major histocompatibility complex, class I, B(HLA-B)	Homo sapiens
1B58_HUMAN	major histocompatibility complex, class I, B(HLA-B)	Homo sapiens
1B07_HUMAN	major histocompatibility complex, class I, B(HLA-B)	Homo sapiens
1B50_HUMAN	major histocompatibility complex, class I, B(HLA-B)	Homo sapiens
1B41_HUMAN	major histocompatibility complex, class I, B(HLA-B)	Homo sapiens
1B56_HUMAN	major histocompatibility complex, class I, B(HLA-B)	Homo sapiens
1B46_HUMAN	major histocompatibility complex, class I, B(HLA-B)	Homo sapiens
1B38_HUMAN	major histocompatibility complex, class I, B(HLA-B)	Homo sapiens
1B73_HUMAN	major histocompatibility complex, class I, B(HLA-B)	Homo sapiens
1C05_HUMAN	major histocompatibility complex, class I, B(HLA-B)	Homo sapiens
1B13_HUMAN	major histocompatibility complex, class I, B(HLA-B)	Homo sapiens
1B39_HUMAN	major histocompatibility complex, class I, B(HLA-B)	Homo sapiens
1B55_HUMAN	major histocompatibility complex, class I, B(HLA-B)	Homo sapiens
1B27_HUMAN	major histocompatibility complex, class I, B(HLA-B)	Homo sapiens
1B67_HUMAN	major histocompatibility complex, class I, B(HLA-B)	Homo sapiens
1B40_HUMAN	major histocompatibility complex, class I, B(HLA-B)	Homo sapiens
1B14_HUMAN	major histocompatibility complex, class I, B(HLA-B)	Homo sapiens
1C02_HUMAN	major histocompatibility complex, class I, C(HLA-C)	Homo sapiens
1C04_HUMAN	major histocompatibility complex, class I, C(HLA-C)	Homo sapiens
1C16_HUMAN	major histocompatibility complex, class I, C(HLA-C)	Homo sapiens
1C06_HUMAN	major histocompatibility complex, class I, C(HLA-C)	Homo sapiens
1C01_HUMAN	major histocompatibility complex, class I, C(HLA-C)	Homo sapiens
1C12_HUMAN	major histocompatibility complex, class I, C(HLA-C)	Homo sapiens
1C07_HUMAN	major histocompatibility complex, class I, C(HLA-C)	Homo sapiens
1C15_HUMAN	major histocompatibility complex, class I, C(HLA-C)	Homo sapiens
1C14_HUMAN	major histocompatibility complex, class I, C(HLA-C)	Homo sapiens
LOXL3_HUMAN	lysyl oxidase like 3(LOXL3)	Homo sapiens
1A33_HUMAN	major histocompatibility complex, class I, A(HLA-A)	Homo sapiens
1A31_HUMAN	major histocompatibility complex, class I, A(HLA-A)	Homo sapiens
1A11_HUMAN	major histocompatibility complex, class I, A(HLA-A)	Homo sapiens
1A01_HUMAN	major histocompatibility complex, class I, A(HLA-A)	Homo sapiens
1A43_HUMAN	major histocompatibility complex, class I, A(HLA-A)	Homo sapiens
1A30_HUMAN	major histocompatibility complex, class I, A(HLA-A)	Homo sapiens
1A74_HUMAN	major histocompatibility complex, class I, A(HLA-A)	Homo sapiens
1A36_HUMAN	major histocompatibility complex, class I, A(HLA-A)	Homo sapiens
1A69_HUMAN	major histocompatibility complex, class I, A(HLA-A)	Homo sapiens
1A26_HUMAN	major histocompatibility complex, class I, A(HLA-A)	Homo sapiens
1A34_HUMAN	major histocompatibility complex, class I, A(HLA-A)	Homo sapiens
1A66_HUMAN	major histocompatibility complex, class I, A(HLA-A)	Homo sapiens
1A68_HUMAN	major histocompatibility complex, class I, A(HLA-A)	Homo sapiens
1A80_HUMAN	major histocompatibility complex, class I, A(HLA-A)	Homo sapiens
1A24_HUMAN	major histocompatibility complex, class I, A(HLA-A)	Homo sapiens
1A23_HUMAN	major histocompatibility complex, class I, A(HLA-A)	Homo sapiens
1A02_HUMAN	major histocompatibility complex, class I, A(HLA-A)	Homo sapiens
1A32_HUMAN	major histocompatibility complex, class I, A(HLA-A)	Homo sapiens
1A03_HUMAN	major histocompatibility complex, class I, A(HLA-A)	Homo sapiens
1A25_HUMAN	major histocompatibility complex, class I, A(HLA-A)	Homo sapiens
RIMS1_HUMAN	regulating synaptic membrane exocytosis 1(RIMS1)	Homo sapiens
TERA_HUMAN	valosin containing protein(VCP)	Homo sapiens
VINC_HUMAN	vinculin(VCL)	Homo sapiens
VCAM1_HUMAN	vascular cell adhesion molecule 1(VCAM1)	Homo sapiens
IGLL1_HUMAN	immunoglobulin lambda like polypeptide 1(IGLL1)	Homo sapiens
LDH6B_HUMAN	lactate dehydrogenase A like 6B(LDHAL6B)	Homo sapiens
USF2_HUMAN	upstream transcription factor 2, c-fos interacting(USF2)	Homo sapiens
UTRO_HUMAN	utrophin(UTRN)	Homo sapiens
IL1AP_HUMAN	interleukin 1 receptor accessory protein(IL1RAP)	Homo sapiens
CXA9_HUMAN	gap junction protein alpha 9(GJA9)	Homo sapiens
COL12_HUMAN	collectin subfamily member 12(COLEC12)	Homo sapiens
DCUP_HUMAN	uroporphyrinogen decarboxylase(UROD)	Homo sapiens
LRC42_HUMAN	leucine rich repeat containing 42(LRRC42)	Homo sapiens
USF1_HUMAN	upstream transcription factor 1(USF1)	Homo sapiens
S6OS1_HUMAN	chromosome 14 open reading frame 39(C14orf39)	Homo sapiens
IL6RA_HUMAN	interleukin 6 receptor(IL6R)	Homo sapiens
COEA1_HUMAN	collagen type XIV alpha 1 chain(COL14A1)	Homo sapiens
PRGC2_HUMAN	PPARG coactivator 1 beta(PPARGC1B)	Homo sapiens
UBP4_HUMAN	ubiquitin specific peptidase 4(USP4)	Homo sapiens
CGT_HUMAN	UDP glycosyltransferase 8(UGT8)	Homo sapiens
UCHL3_HUMAN	ubiquitin C-terminal hydrolase L3(UCHL3)	Homo sapiens
EMAL4_HUMAN	echinoderm microtubule associated protein like 4(EML4)	Homo sapiens
CE052_HUMAN	chromosome 5 open reading frame 52(C5orf52)	Homo sapiens
CECR2_HUMAN	CECR2, histone acetyl-lysine reader(CECR2)	Homo sapiens
RAX2_HUMAN	retina and anterior neural fold homeobox 2(RAX2)	Homo sapiens
UB2L3_HUMAN	ubiquitin conjugating enzyme E2 L3(UBE2L3)	Homo sapiens
MPRI_HUMAN	insulin like growth factor 2 receptor(IGF2R)	Homo sapiens
ALS_HUMAN	insulin like growth factor binding protein acid labile subunit(IGFALS)	Homo sapiens
IGF1R_HUMAN	insulin like growth factor 1 receptor(IGF1R)	Homo sapiens
UB2V2_HUMAN	ubiquitin conjugating enzyme E2 V2(UBE2V2)	Homo sapiens
IGF2_HUMAN	insulin like growth factor 2(IGF2)	Homo sapiens
IBP3_HUMAN	insulin like growth factor binding protein 3(IGFBP3)	Homo sapiens
IBP4_HUMAN	insulin like growth factor binding protein 4(IGFBP4)	Homo sapiens
IBP1_HUMAN	insulin like growth factor binding protein 1(IGFBP1)	Homo sapiens
IBP2_HUMAN	insulin like growth factor binding protein 2(IGFBP2)	Homo sapiens
IBP6_HUMAN	insulin like growth factor binding protein 6(IGFBP6)	Homo sapiens
IBP5_HUMAN	insulin like growth factor binding protein 5(IGFBP5)	Homo sapiens
IBP7_HUMAN	insulin like growth factor binding protein 7(IGFBP7)	Homo sapiens
UBA1_HUMAN	ubiquitin like modifier activating enzyme 1(UBA1)	Homo sapiens
IGHD_HUMAN	immunoglobulin heavy constant delta(IGHD)	Homo sapiens
IGHE_HUMAN	immunoglobulin heavy constant epsilon(IGHE)	Homo sapiens
IGHG3_HUMAN	immunoglobulin heavy constant gamma 3 (G3m marker)(IGHG3)	Homo sapiens
IGHM_HUMAN	immunoglobulin heavy constant mu(IGHM)	Homo sapiens
GPAT3_HUMAN	glycerol-3-phosphate acyltransferase 3(GPAT3)	Homo sapiens
ABCAD_HUMAN	ATP binding cassette subfamily A member 13(ABCA13)	Homo sapiens
IGKC_HUMAN	immunoglobulin kappa constant(IGKC)	Homo sapiens
THIO_HUMAN	thioredoxin(TXN)	Homo sapiens
DMBX1_HUMAN	diencephalon/mesencephalon homeobox 1(DMBX1)	Homo sapiens
TUFT1_HUMAN	tuftelin 1(TUFT1)	Homo sapiens
EFTU_HUMAN	Tu translation elongation factor, mitochondrial(TUFM)	Homo sapiens
IDS_HUMAN	iduronate 2-sulfatase(IDS)	Homo sapiens
IDH3G_HUMAN	isocitrate dehydrogenase 3 (NAD(+)) gamma(IDH3G)	Homo sapiens
TTK_HUMAN	TTK protein kinase(TTK)	Homo sapiens
PXDC2_HUMAN	plexin domain containing 2(PLXDC2)	Homo sapiens
CFAI_HUMAN	complement factor I(CFI)	Homo sapiens
INAR2_HUMAN	interferon alpha and beta receptor subunit 2(IFNAR2)	Homo sapiens
POTEE_HUMAN	POTE ankyrin domain family member E(POTEE)	Homo sapiens
MINA_HUMAN	MYC induced nuclear antigen(MINA)	Homo sapiens
KCD12_HUMAN	potassium channel tetramerization domain containing 12(KCTD12)	Homo sapiens
TRPM2_HUMAN	transient receptor potential cation channel subfamily M member 2(TRPM2)	Homo sapiens
PGBM_HUMAN	heparan sulfate proteoglycan 2(HSPG2)	Homo sapiens
DDX53_HUMAN	DEAD-box helicase 53(DDX53)	Homo sapiens
NDST1_HUMAN	N-deacetylase and N-sulfotransferase 1(NDST1)	Homo sapiens
ADA22_HUMAN	ADAM metallopeptidase domain 22(ADAM22)	Homo sapiens
FRMD5_HUMAN	FERM domain containing 5(FRMD5)	Homo sapiens
SIK1_HUMAN	serine/threonine-protein kinase SIK1(LOC102724428)	Homo sapiens
TRY6_HUMAN	protease, serine 3 pseudogene 2(PRSS3P2)	Homo sapiens
UBS3B_HUMAN	ubiquitin associated and SH3 domain containing B(UBASH3B)	Homo sapiens
TENA_HUMAN	tenascin C(TNC)	Homo sapiens
NUDC1_HUMAN	NudC domain containing 1(NUDCD1)	Homo sapiens
MICLK_HUMAN	MICAL C-terminal like(MICALCL)	Homo sapiens
CGNL1_HUMAN	cingulin like 1(CGNL1)	Homo sapiens
ENPL_HUMAN	heat shock protein 90 beta family member 1(HSP90B1)	Homo sapiens
PR38A_HUMAN	pre-mRNA processing factor 38A(PRPF38A)	Homo sapiens
AMOL1_HUMAN	angiomotin like 1(AMOTL1)	Homo sapiens
ICAM3_HUMAN	intercellular adhesion molecule 3(ICAM3)	Homo sapiens
TRYB1_HUMAN	tryptase alpha/beta 1(TPSAB1)	Homo sapiens
ICAM2_HUMAN	intercellular adhesion molecule 2(ICAM2)	Homo sapiens
XKR2_HUMAN	XK related, X-linked(XKRX)	Homo sapiens
U17L6_HUMAN	ubiquitin specific peptidase 17-like family member 6, pseudogene(USP17L6P)	Homo sapiens
CRIS2_HUMAN	cysteine rich secretory protein 2(CRISP2)	Homo sapiens
TPM2_HUMAN	tropomyosin 2 (beta)(TPM2)	Homo sapiens
TPM1_HUMAN	tropomyosin 1 (alpha)(TPM1)	Homo sapiens
TPM4_HUMAN	tropomyosin 4(TPM4)	Homo sapiens
TPM3_HUMAN	tropomyosin 3(TPM3)	Homo sapiens
PERT_HUMAN	thyroid peroxidase(TPO)	Homo sapiens
DDT4L_HUMAN	DNA damage inducible transcript 4 like(DDIT4L)	Homo sapiens
U17L1_HUMAN	ubiquitin specific peptidase 17-like family member 1(USP17L1)	Homo sapiens
KI13B_HUMAN	kinesin family member 13B(KIF13B)	Homo sapiens
CABP7_HUMAN	calcium binding protein 7(CABP7)	Homo sapiens
ATMIN_HUMAN	ATM interactor(ATMIN)	Homo sapiens
TSSK6_HUMAN	testis specific serine kinase 6(TSSK6)	Homo sapiens
SIN3B_HUMAN	SIN3 transcription regulator family member B(SIN3B)	Homo sapiens
CA122_HUMAN	chromosome 1 open reading frame 122(C1orf122)	Homo sapiens
DMXL2_HUMAN	Dmx like 2(DMXL2)	Homo sapiens
KIT_HUMAN	KIT proto-oncogene receptor tyrosine kinase(KIT)	Homo sapiens
KLKB1_HUMAN	kallikrein B1(KLKB1)	Homo sapiens
MA2B2_HUMAN	mannosidase alpha class 2B member 2(MAN2B2)	Homo sapiens
DNER_HUMAN	delta/notch like EGF repeat containing(DNER)	Homo sapiens
KIF5A_HUMAN	kinesin family member 5A(KIF5A)	Homo sapiens
VPS39_HUMAN	VPS39, HOPS complex subunit(VPS39)	Homo sapiens
UT2_HUMAN	solute carrier family 14 member 2(SLC14A2)	Homo sapiens
THAP5_HUMAN	THAP domain containing 5(THAP5)	Homo sapiens
K2C6C_HUMAN	keratin 6C(KRT6C)	Homo sapiens
TMPS6_HUMAN	transmembrane protease, serine 6(TMPRSS6)	Homo sapiens
ELL_HUMAN	elongation factor for RNA polymerase II(ELL)	Homo sapiens
CNTN5_HUMAN	contactin 5(CNTN5)	Homo sapiens
SR140_HUMAN	U2 snRNP associated SURP domain containing(U2SURP)	Homo sapiens
ZP4_HUMAN	zona pellucida glycoprotein 4(ZP4)	Homo sapiens
KCNQ2_HUMAN	potassium voltage-gated channel subfamily Q member 2(KCNQ2)	Homo sapiens
UBR4_HUMAN	ubiquitin protein ligase E3 component n-recognin 4(UBR4)	Homo sapiens
KCNQ1_HUMAN	potassium voltage-gated channel subfamily Q member 1(KCNQ1)	Homo sapiens
HAUS5_HUMAN	HAUS augmin like complex subunit 5(HAUS5)	Homo sapiens
KCNQ3_HUMAN	potassium voltage-gated channel subfamily Q member 3(KCNQ3)	Homo sapiens
VGFR2_HUMAN	kinase insert domain receptor(KDR)	Homo sapiens
OBSL1_HUMAN	obscurin like 1(OBSL1)	Homo sapiens
CUL5_HUMAN	cullin 5(CUL5)	Homo sapiens
MFAP5_HUMAN	microfibrillar associated protein 5(MFAP5)	Homo sapiens
ARHGI_HUMAN	Rho/Rac guanine nucleotide exchange factor 18(ARHGEF18)	Homo sapiens
ASPP1_HUMAN	protein phosphatase 1 regulatory subunit 13B(PPP1R13B)	Homo sapiens
LAS1L_HUMAN	LAS1 like, ribosome biogenesis factor(LAS1L)	Homo sapiens
ZN506_HUMAN	zinc finger protein 506(ZNF506)	Homo sapiens
KCNB1_HUMAN	potassium voltage-gated channel subfamily B member 1(KCNB1)	Homo sapiens
KCA10_HUMAN	potassium voltage-gated channel subfamily A member 10(KCNA10)	Homo sapiens
GPR98_HUMAN	adhesion G protein-coupled receptor V1(ADGRV1)	Homo sapiens
NUDC3_HUMAN	NudC domain containing 3(NUDCD3)	Homo sapiens
KIRR2_HUMAN	kin of IRRE like 2 (Drosophila)(KIRREL2)	Homo sapiens
IFT88_HUMAN	intraflagellar transport 88(IFT88)	Homo sapiens
MAGB6_HUMAN	MAGE family member B6(MAGEB6)	Homo sapiens
PI51C_HUMAN	phosphatidylinositol-4-phosphate 5-kinase type 1 gamma(PIP5K1C)	Homo sapiens
SYK_HUMAN	lysyl-tRNA synthetase(KARS)	Homo sapiens
EXOS2_HUMAN	exosome component 2(EXOSC2)	Homo sapiens
RHXF1_HUMAN	Rhox homeobox family member 1(RHOXF1)	Homo sapiens
MARK4_HUMAN	microtubule affinity regulating kinase 4(MARK4)	Homo sapiens
CC020_HUMAN	chromosome 3 open reading frame 20(C3orf20)	Homo sapiens
JAK2_HUMAN	Janus kinase 2(JAK2)	Homo sapiens
HYI_HUMAN	hydroxypyruvate isomerase (putative)(HYI)	Homo sapiens
NOMO1_HUMAN	NODAL modulator 1(NOMO1)	Homo sapiens
NCKP5_HUMAN	NCK associated protein 5(NCKAP5)	Homo sapiens
AMNLS_HUMAN	amnion associated transmembrane protein(AMN)	Homo sapiens
ITPR3_HUMAN	inositol 1,4,5-trisphosphate receptor type 3(ITPR3)	Homo sapiens
ITPR2_HUMAN	inositol 1,4,5-trisphosphate receptor type 2(ITPR2)	Homo sapiens
HNRLL_HUMAN	heterogeneous nuclear ribonucleoprotein L like(HNRNPLL)	Homo sapiens
PRAM_HUMAN	PML-RARA regulated adaptor molecule 1(PRAM1)	Homo sapiens
ITPR1_HUMAN	inositol 1,4,5-trisphosphate receptor type 1(ITPR1)	Homo sapiens
ITIH3_HUMAN	inter-alpha-trypsin inhibitor heavy chain 3(ITIH3)	Homo sapiens
UBP44_HUMAN	ubiquitin specific peptidase 44(USP44)	Homo sapiens
MGT4B_HUMAN	mannosyl (alpha-1,3-)-glycoprotein beta-1,4-N-acetylglucosaminyltransferase, isozyme B(MGAT4B)	Homo sapiens
ITIH1_HUMAN	inter-alpha-trypsin inhibitor heavy chain 1(ITIH1)	Homo sapiens
TRYD_HUMAN	tryptase delta 1(TPSD1)	Homo sapiens
ITIH4_HUMAN	inter-alpha-trypsin inhibitor heavy chain family member 4(ITIH4)	Homo sapiens
ITB3_HUMAN	integrin subunit beta 3(ITGB3)	Homo sapiens
NDK8_HUMAN	NME/NM23 nucleoside diphosphate kinase 2 pseudogene 1(NME2P1)	Homo sapiens
KLHL2_HUMAN	kelch like family member 2(KLHL2)	Homo sapiens
PROL4_HUMAN	proline rich 4 (lacrimal)(PRR4)	Homo sapiens
ITB6_HUMAN	integrin subunit beta 6(ITGB6)	Homo sapiens
RALYL_HUMAN	RALY RNA binding protein-like(RALYL)	Homo sapiens
ITAL_HUMAN	integrin subunit alpha L(ITGAL)	Homo sapiens
ITA9_HUMAN	integrin subunit alpha 9(ITGA9)	Homo sapiens
GXLT1_HUMAN	glucoside xylosyltransferase 1(GXYLT1)	Homo sapiens
CTL1_HUMAN	solute carrier family 44 member 1(SLC44A1)	Homo sapiens
ITAM_HUMAN	integrin subunit alpha M(ITGAM)	Homo sapiens
NU214_HUMAN	nucleoporin 214(NUP214)	Homo sapiens
ITA2_HUMAN	integrin subunit alpha 2(ITGA2)	Homo sapiens
OPLA_HUMAN	5-oxoprolinase (ATP-hydrolysing)(OPLAH)	Homo sapiens
IGDC4_HUMAN	immunoglobulin superfamily DCC subclass member 4(IGDCC4)	Homo sapiens
VASN_HUMAN	vasorin(VASN)	Homo sapiens
RASF7_HUMAN	Ras association domain family member 7(RASSF7)	Homo sapiens
FSD2_HUMAN	fibronectin type III and SPRY domain containing 2(FSD2)	Homo sapiens
VSIG4_HUMAN	V-set and immunoglobulin domain containing 4(VSIG4)	Homo sapiens
IRF7_HUMAN	interferon regulatory factor 7(IRF7)	Homo sapiens
LYPA2_HUMAN	lysophospholipase II(LYPLA2)	Homo sapiens
UBP42_HUMAN	ubiquitin specific peptidase 42(USP42)	Homo sapiens
PARK7_HUMAN	Parkinsonism associated deglycase(PARK7)	Homo sapiens
ISLR_HUMAN	immunoglobulin superfamily containing leucine rich repeat(ISLR)	Homo sapiens
DYH14_HUMAN	dynein axonemal heavy chain 14(DNAH14)	Homo sapiens
SO2B1_HUMAN	solute carrier organic anion transporter family member 2B1(SLCO2B1)	Homo sapiens
FANCM_HUMAN	Fanconi anemia complementation group M(FANCM)	Homo sapiens
IPP_HUMAN	intracisternal A particle-promoted polypeptide(IPP)	Homo sapiens
ZN644_HUMAN	zinc finger protein 644(ZNF644)	Homo sapiens
CWC22_HUMAN	CWC22 spliceosome associated protein homolog(CWC22)	Homo sapiens
DPP10_HUMAN	dipeptidyl peptidase like 10(DPP10)	Homo sapiens
LOXL4_HUMAN	lysyl oxidase like 4(LOXL4)	Homo sapiens
MACF1_HUMAN	microtubule-actin crosslinking factor 1(MACF1)	Homo sapiens
KLHL1_HUMAN	kelch like family member 1(KLHL1)	Homo sapiens
STIM2_HUMAN	stromal interaction molecule 2(STIM2)	Homo sapiens
PAFA_HUMAN	phospholipase A2 group VII(PLA2G7)	Homo sapiens
SHIP1_HUMAN	inositol polyphosphate-5-phosphatase D(INPP5D)	Homo sapiens
INHBC_HUMAN	inhibin beta C subunit(INHBC)	Homo sapiens
NU188_HUMAN	nucleoporin 188(NUP188)	Homo sapiens
I23O1_HUMAN	indoleamine 2,3-dioxygenase 1(IDO1)	Homo sapiens
CCD73_HUMAN	coiled-coil domain containing 73(CCDC73)	Homo sapiens
LRC8B_HUMAN	leucine rich repeat containing 8 family member B(LRRC8B)	Homo sapiens
FNIP2_HUMAN	folliculin interacting protein 2(FNIP2)	Homo sapiens
LRC39_HUMAN	leucine rich repeat containing 39(LRRC39)	Homo sapiens
CDHR5_HUMAN	cadherin related family member 5(CDHR5)	Homo sapiens
TM131_HUMAN	transmembrane protein 131(TMEM131)	Homo sapiens
FKBP9_HUMAN	FK506 binding protein 9(FKBP9)	Homo sapiens
HV102_HUMAN	immunoglobulin heavy variable 1/OR15-1 (non-functional)(IGHV1OR15-1)	Homo sapiens
F188B_HUMAN	family with sequence similarity 188 member B(FAM188B)	Homo sapiens
IMPA2_HUMAN	inositol monophosphatase 2(IMPA2)	Homo sapiens
TPC3L_HUMAN	trafficking protein particle complex 3 like(TRAPPC3L)	Homo sapiens
TRIM7_HUMAN	tripartite motif containing 7(TRIM7)	Homo sapiens
CAMP3_HUMAN	calmodulin regulated spectrin associated protein family member 3(CAMSAP3)	Homo sapiens
PHRF1_HUMAN	PHD and ring finger domains 1(PHRF1)	Homo sapiens
CACO1_HUMAN	calcium binding and coiled-coil domain 1(CALCOCO1)	Homo sapiens
ILK_HUMAN	integrin linked kinase(ILK)	Homo sapiens
NNTM_HUMAN	nicotinamide nucleotide transhydrogenase(NNT)	Homo sapiens
KSR2_HUMAN	kinase suppressor of ras 2(KSR2)	Homo sapiens
MYH7B_HUMAN	myosin heavy chain 7B(MYH7B)	Homo sapiens
LONF2_HUMAN	LON peptidase N-terminal domain and ring finger 2(LONRF2)	Homo sapiens
SE6L1_HUMAN	seizure related 6 homolog like(SEZ6L)	Homo sapiens
LIRA4_HUMAN	leukocyte immunoglobulin like receptor A4(LILRA4)	Homo sapiens
CC146_HUMAN	coiled-coil domain containing 146(CCDC146)	Homo sapiens
ZN541_HUMAN	zinc finger protein 541(ZNF541)	Homo sapiens
WDR35_HUMAN	WD repeat domain 35(WDR35)	Homo sapiens
ALPK3_HUMAN	alpha kinase 3(ALPK3)	Homo sapiens
MTNA_HUMAN	methylthioribose-1-phosphate isomerase 1(MRI1)	Homo sapiens
ES1_HUMAN	ES1 protein homolog, mitochondrial(LOC102724023)	Homo sapiens
LYSC_HUMAN	lysozyme(LYZ)	Homo sapiens
S38A1_HUMAN	solute carrier family 38 member 1(SLC38A1)	Homo sapiens
PDP2_HUMAN	pyruvate dehyrogenase phosphatase catalytic subunit 2(PDP2)	Homo sapiens
PSD2_HUMAN	pleckstrin and Sec7 domain containing 2(PSD2)	Homo sapiens
MANF_HUMAN	mesencephalic astrocyte derived neurotrophic factor(MANF)	Homo sapiens
RHPN1_HUMAN	rhophilin Rho GTPase binding protein 1(RHPN1)	Homo sapiens
MAD1_HUMAN	MAX dimerization protein 1(MXD1)	Homo sapiens
KCIP1_HUMAN	potassium voltage-gated channel interacting protein 1(KCNIP1)	Homo sapiens
CB016_HUMAN	chromosome 2 open reading frame 16(C2orf16)	Homo sapiens
PDS5B_HUMAN	PDS5 cohesin associated factor B(PDS5B)	Homo sapiens
B4GN3_HUMAN	beta-1,4-N-acetyl-galactosaminyltransferase 3(B4GALNT3)	Homo sapiens
SMAD3_HUMAN	SMAD family member 3(SMAD3)	Homo sapiens
TXND5_HUMAN	thioredoxin domain containing 5(TXNDC5)	Homo sapiens
KCAB1_HUMAN	potassium voltage-gated channel subfamily A member regulatory beta subunit 1(KCNAB1)	Homo sapiens
IFT80_HUMAN	intraflagellar transport 80(IFT80)	Homo sapiens
PKHL1_HUMAN	polycystic kidney and hepatic disease 1 (autosomal recessive)-like 1(PKHD1L1)	Homo sapiens
SCAPE_HUMAN	S-phase cyclin A associated protein in the ER(SCAPER)	Homo sapiens
ENDD1_HUMAN	endonuclease domain containing 1(ENDOD1)	Homo sapiens
FHAD1_HUMAN	forkhead associated phosphopeptide binding domain 1(FHAD1)	Homo sapiens
K2012_HUMAN	KIAA2012(KIAA2012)	Homo sapiens
ZC3HD_HUMAN	zinc finger CCCH-type containing 13(ZC3H13)	Homo sapiens
LRMP_HUMAN	lymphoid restricted membrane protein(LRMP)	Homo sapiens
TTLL9_HUMAN	tubulin tyrosine ligase like 9(TTLL9)	Homo sapiens
ZBT43_HUMAN	zinc finger and BTB domain containing 43(ZBTB43)	Homo sapiens
KIF17_HUMAN	kinesin family member 17(KIF17)	Homo sapiens
UNC79_HUMAN	unc-79 homolog (C. elegans)(UNC79)	Homo sapiens
BTBDA_HUMAN	BTB domain containing 10(BTBD10)	Homo sapiens
TBD2B_HUMAN	TBC1 domain family member 2B(TBC1D2B)	Homo sapiens
CYC_HUMAN	cytochrome c, somatic(CYCS)	Homo sapiens
LSAMP_HUMAN	limbic system-associated membrane protein(LSAMP)	Homo sapiens
MF2L2_HUMAN	MCF.2 cell line derived transforming sequence-like 2(MCF2L2)	Homo sapiens
CP4F3_HUMAN	cytochrome P450 family 4 subfamily F member 3(CYP4F3)	Homo sapiens
LKHA4_HUMAN	leukotriene A4 hydrolase(LTA4H)	Homo sapiens
FETUB_HUMAN	fetuin B(FETUB)	Homo sapiens
LTBP1_HUMAN	latent transforming growth factor beta binding protein 1(LTBP1)	Homo sapiens
DCNL5_HUMAN	defective in cullin neddylation 1 domain containing 5(DCUN1D5)	Homo sapiens
MYCB2_HUMAN	MYC binding protein 2, E3 ubiquitin protein ligase(MYCBP2)	Homo sapiens
LTBP2_HUMAN	latent transforming growth factor beta binding protein 2(LTBP2)	Homo sapiens
BCAM_HUMAN	basal cell adhesion molecule (Lutheran blood group)(BCAM)	Homo sapiens
ISY1_HUMAN	ISY1-RAB43 readthrough(ISY1-RAB43)	Homo sapiens
TRFL_HUMAN	lactotransferrin(LTF)	Homo sapiens
LUM_HUMAN	lumican(LUM)	Homo sapiens
ZN397_HUMAN	zinc finger protein 397(ZNF397)	Homo sapiens
CMTA2_HUMAN	calmodulin binding transcription activator 2(CAMTA2)	Homo sapiens
C1QT3_HUMAN	C1q and tumor necrosis factor related protein 3(C1QTNF3)	Homo sapiens
LMNB1_HUMAN	lamin B1(LMNB1)	Homo sapiens
C1QT4_HUMAN	C1q and tumor necrosis factor related protein 4(C1QTNF4)	Homo sapiens
SH24B_HUMAN	SH2 domain containing 4B(SH2D4B)	Homo sapiens
VMA5A_HUMAN	von Willebrand factor A domain containing 5A(VWA5A)	Homo sapiens
NEUL_HUMAN	neurolysin(NLN)	Homo sapiens
LYOX_HUMAN	lysyl oxidase(LOX)	Homo sapiens
FBX32_HUMAN	F-box protein 32(FBXO32)	Homo sapiens
BRM1L_HUMAN	breast cancer metastasis-suppressor 1-like(BRMS1L)	Homo sapiens
ZN445_HUMAN	zinc finger protein 445(ZNF445)	Homo sapiens
TSN14_HUMAN	tetraspanin 14(TSPAN14)	Homo sapiens
LIPL_HUMAN	lipoprotein lipase(LPL)	Homo sapiens
HEG1_HUMAN	heart development protein with EGF like domains 1(HEG1)	Homo sapiens
UN93B_HUMAN	unc-93 homolog B1 (C. elegans)(UNC93B1)	Homo sapiens
CDT1_HUMAN	chromatin licensing and DNA replication factor 1(CDT1)	Homo sapiens
TAB2_HUMAN	TGF-beta activated kinase 1/MAP3K7 binding protein 2(TAB2)	Homo sapiens
SAT2_HUMAN	spermidine/spermine N1-acetyltransferase family member 2(SAT2)	Homo sapiens
RIM3B_HUMAN	RIMS binding protein 3B(RIMBP3B)	Homo sapiens
NCDN_HUMAN	neurochondrin(NCDN)	Homo sapiens
PCSK9_HUMAN	proprotein convertase subtilisin/kexin type 9(PCSK9)	Homo sapiens
HPS3_HUMAN	HPS3, biogenesis of lysosomal organelles complex 2 subunit 1(HPS3)	Homo sapiens
STAB1_HUMAN	stabilin 1(STAB1)	Homo sapiens
DNLI4_HUMAN	DNA ligase 4(LIG4)	Homo sapiens
STAR9_HUMAN	StAR related lipid transfer domain containing 9(STARD9)	Homo sapiens
NU205_HUMAN	nucleoporin 205(NUP205)	Homo sapiens
GP158_HUMAN	G protein-coupled receptor 158(GPR158)	Homo sapiens
SERC1_HUMAN	serine incorporator 1(SERINC1)	Homo sapiens
LRCH1_HUMAN	leucine rich repeats and calponin homology domain containing 1(LRCH1)	Homo sapiens
LIPS_HUMAN	lipase E, hormone sensitive type(LIPE)	Homo sapiens
ACBD6_HUMAN	acyl-CoA binding domain containing 6(ACBD6)	Homo sapiens
LIMS1_HUMAN	LIM zinc finger domain containing 1(LIMS1)	Homo sapiens
ZBED3_HUMAN	zinc finger BED-type containing 3(ZBED3)	Homo sapiens
PIWL3_HUMAN	piwi like RNA-mediated gene silencing 3(PIWIL3)	Homo sapiens
MOGS_HUMAN	mannosyl-oligosaccharide glucosidase(MOGS)	Homo sapiens
LMAN1_HUMAN	lectin, mannose binding 1(LMAN1)	Homo sapiens
IL1R2_HUMAN	interleukin 1 receptor type 2(IL1R2)	Homo sapiens
CING_HUMAN	cingulin(CGN)	Homo sapiens
ZC3H3_HUMAN	zinc finger CCCH-type containing 3(ZC3H3)	Homo sapiens
GANAB_HUMAN	glucosidase II alpha subunit(GANAB)	Homo sapiens
STML2_HUMAN	stomatin like 2(STOML2)	Homo sapiens
LDHB_HUMAN	lactate dehydrogenase B(LDHB)	Homo sapiens
ZN226_HUMAN	zinc finger protein 226(ZNF226)	Homo sapiens
ATG4B_HUMAN	autophagy related 4B cysteine peptidase(ATG4B)	Homo sapiens
ZN320_HUMAN	zinc finger protein 320(ZNF320)	Homo sapiens
LDHC_HUMAN	lactate dehydrogenase C(LDHC)	Homo sapiens
LDLR_HUMAN	low density lipoprotein receptor(LDLR)	Homo sapiens
F120A_HUMAN	family with sequence similarity 120A(FAM120A)	Homo sapiens
PLSL_HUMAN	lymphocyte cytosolic protein 1(LCP1)	Homo sapiens
LDHA_HUMAN	lactate dehydrogenase A(LDHA)	Homo sapiens
CYFP1_HUMAN	cytoplasmic FMR1 interacting protein 1(CYFIP1)	Homo sapiens
ZN200_HUMAN	zinc finger protein 200(ZNF200)	Homo sapiens
RGL1_HUMAN	ral guanine nucleotide dissociation stimulator like 1(RGL1)	Homo sapiens
LEG8_HUMAN	galectin 8(LGALS8)	Homo sapiens
LEPR_HUMAN	leptin receptor(LEPR)	Homo sapiens
RTF1_HUMAN	RTF1 homolog, Paf1/RNA polymerase II complex component(RTF1)	Homo sapiens
LEP_HUMAN	leptin(LEP)	Homo sapiens
LETM1_HUMAN	leucine zipper and EF-hand containing transmembrane protein 1(LETM1)	Homo sapiens
LEG1_HUMAN	galectin 1(LGALS1)	Homo sapiens
LG3BP_HUMAN	galectin 3 binding protein(LGALS3BP)	Homo sapiens
F161B_HUMAN	family with sequence similarity 161 member B(FAM161B)	Homo sapiens
LPIN1_HUMAN	lipin 1(LPIN1)	Homo sapiens
LAMC1_HUMAN	laminin subunit gamma 1(LAMC1)	Homo sapiens
PO210_HUMAN	nucleoporin 210(NUP210)	Homo sapiens
LAMB2_HUMAN	laminin subunit beta 2(LAMB2)	Homo sapiens
SYNE2_HUMAN	spectrin repeat containing nuclear envelope protein 2(SYNE2)	Homo sapiens
NOE2_HUMAN	olfactomedin 2(OLFM2)	Homo sapiens
SE1L3_HUMAN	SEL1L family member 3(SEL1L3)	Homo sapiens
SIG14_HUMAN	sialic acid binding Ig like lectin 14(SIGLEC14)	Homo sapiens
LAMP1_HUMAN	lysosomal associated membrane protein 1(LAMP1)	Homo sapiens
ZBT11_HUMAN	zinc finger and BTB domain containing 11(ZBTB11)	Homo sapiens
TBCD1_HUMAN	TBC1 domain family member 1(TBC1D1)	Homo sapiens
LAMA4_HUMAN	laminin subunit alpha 4(LAMA4)	Homo sapiens
LAMA5_HUMAN	laminin subunit alpha 5(LAMA5)	Homo sapiens
PRDM2_HUMAN	PR/SET domain 2(PRDM2)	Homo sapiens
LAMA2_HUMAN	laminin subunit alpha 2(LAMA2)	Homo sapiens
LCAT_HUMAN	lecithin-cholesterol acyltransferase(LCAT)	Homo sapiens
M3K12_HUMAN	mitogen-activated protein kinase kinase kinase 12(MAP3K12)	Homo sapiens
LBP_HUMAN	lipopolysaccharide binding protein(LBP)	Homo sapiens
XPO6_HUMAN	exportin 6(XPO6)	Homo sapiens
KCNH5_HUMAN	potassium voltage-gated channel subfamily H member 5(KCNH5)	Homo sapiens
DKK3_HUMAN	dickkopf WNT signaling pathway inhibitor 3(DKK3)	Homo sapiens
RSSA_HUMAN	ribosomal protein SA(RPSA)	Homo sapiens
AT11B_HUMAN	ATPase phospholipid transporting 11B (putative)(ATP11B)	Homo sapiens
LAMP2_HUMAN	lysosomal associated membrane protein 2(LAMP2)	Homo sapiens
SMC1B_HUMAN	structural maintenance of chromosomes 1B(SMC1B)	Homo sapiens
AFF4_HUMAN	AF4/FMR2 family member 4(AFF4)	Homo sapiens
KT33B_HUMAN	keratin 33B(KRT33B)	Homo sapiens
FRPD3_HUMAN	FERM and PDZ domain containing 3(FRMPD3)	Homo sapiens
KRT35_HUMAN	keratin 35(KRT35)	Homo sapiens
MAML2_HUMAN	mastermind like transcriptional coactivator 2(MAML2)	Homo sapiens
KRT81_HUMAN	keratin 81(KRT81)	Homo sapiens
FOXD3_HUMAN	forkhead box D3(FOXD3)	Homo sapiens
K1C19_HUMAN	keratin 19(KRT19)	Homo sapiens
K1H1_HUMAN	keratin 31(KRT31)	Homo sapiens
K1H2_HUMAN	keratin 32(KRT32)	Homo sapiens
DEN5A_HUMAN	DENN domain containing 5A(DENND5A)	Homo sapiens
ANR12_HUMAN	ankyrin repeat domain 12(ANKRD12)	Homo sapiens
CLIC6_HUMAN	chloride intracellular channel 6(CLIC6)	Homo sapiens
ZN142_HUMAN	zinc finger protein 142(ZNF142)	Homo sapiens
PGRP2_HUMAN	peptidoglycan recognition protein 2(PGLYRP2)	Homo sapiens
ZN143_HUMAN	zinc finger protein 143(ZNF143)	Homo sapiens
K1C17_HUMAN	keratin 17(KRT17)	Homo sapiens
K1024_HUMAN	KIAA1024(KIAA1024)	Homo sapiens
K1C18_HUMAN	keratin 18(KRT18)	Homo sapiens
PDS5A_HUMAN	PDS5 cohesin associated factor A(PDS5A)	Homo sapiens
DMKN_HUMAN	dermokine(DMKN)	Homo sapiens
SETD4_HUMAN	SET domain containing 4(SETD4)	Homo sapiens
PK2L2_HUMAN	polycystin 2 like 2, transient receptor potential cation channel(PKD2L2)	Homo sapiens
L1CAM_HUMAN	L1 cell adhesion molecule(L1CAM)	Homo sapiens
T131L_HUMAN	KIAA0922(KIAA0922)	Homo sapiens
KRT86_HUMAN	keratin 86(KRT86)	Homo sapiens
NPHP3_HUMAN	nephrocystin 3(NPHP3)	Homo sapiens
KRT85_HUMAN	keratin 85(KRT85)	Homo sapiens
K2C6B_HUMAN	keratin 6B(KRT6B)	Homo sapiens
MGRN1_HUMAN	mahogunin ring finger 1(MGRN1)	Homo sapiens
K2C7_HUMAN	keratin 7(KRT7)	Homo sapiens
K2C5_HUMAN	keratin 5(KRT5)	Homo sapiens
K2C6A_HUMAN	keratin 6A(KRT6A)	Homo sapiens
K2C3_HUMAN	keratin 3(KRT3)	Homo sapiens
K2C4_HUMAN	keratin 4(KRT4)	Homo sapiens
K2C1_HUMAN	keratin 1(KRT1)	Homo sapiens
OAF_HUMAN	out at first homolog(OAF)	Homo sapiens
U17L8_HUMAN	ubiquitin specific peptidase 17-like family member 8(USP17L8)	Homo sapiens
LMBL3_HUMAN	l(3)mbt-like 3 (Drosophila)(L3MBTL3)	Homo sapiens
FMNL2_HUMAN	formin like 2(FMNL2)	Homo sapiens
K1C16_HUMAN	keratin 16(KRT16)	Homo sapiens
AB12B_HUMAN	abhydrolase domain containing 12B(ABHD12B)	Homo sapiens
ESCO1_HUMAN	establishment of sister chromatid cohesion N-acetyltransferase 1(ESCO1)	Homo sapiens
K1C15_HUMAN	keratin 15(KRT15)	Homo sapiens
NEUL4_HUMAN	neuralized E3 ubiquitin protein ligase 4(NEURL4)	Homo sapiens
RB22A_HUMAN	RAB22A, member RAS oncogene family(RAB22A)	Homo sapiens
K1C14_HUMAN	keratin 14(KRT14)	Homo sapiens
MBD6_HUMAN	methyl-CpG binding domain protein 6(MBD6)	Homo sapiens
M3KL4_HUMAN	mixed lineage kinase 4(MLK4)	Homo sapiens
K1C12_HUMAN	keratin 12(KRT12)	Homo sapiens
K1C10_HUMAN	keratin 10(KRT10)	Homo sapiens
K1C9_HUMAN	keratin 9(KRT9)	Homo sapiens
K2C8_HUMAN	keratin 8(KRT8)	Homo sapiens
CSMD3_HUMAN	CUB and Sushi multiple domains 3(CSMD3)	Homo sapiens
EFCB7_HUMAN	EF-hand calcium binding domain 7(EFCAB7)	Homo sapiens
	RICH2_HUMAN		
	F27E1_HUMAN		
	LV302_HUMAN		
	KV124_HUMAN		
	LV204_HUMAN		
	GP116_HUMAN		
	UBP17_HUMAN		
	K1688_HUMAN		
	CB053_HUMAN		
	LPLC1_HUMAN		
	STG34_HUMAN		
	CI169_HUMAN		
	PME17_HUMAN		
	YE017_HUMAN		
	KV125_HUMAN		
	HV101_HUMAN		
	UBFL3_HUMAN		
	KV119_HUMAN		
	AZI1_HUMAN		
	HV316_HUMAN		
	LV101_HUMAN		
	MCAR1_HUMAN		
	YA028_HUMAN		
	KV402_HUMAN		
	CE025_HUMAN		
	KV405_HUMAN		
	UB2CB_HUMAN		
	HV106_HUMAN		
	CL063_HUMAN		
	HV305_HUMAN		
	F179B_HUMAN		
	S72L2_HUMAN		
	ACCN2_HUMAN		
	K1731_HUMAN		
	LV105_HUMAN		
	LV001_HUMAN		
	PN6BL_HUMAN		
	HV306_HUMAN		
	CQ066_HUMAN		
	KV201_HUMAN		
	LV210_HUMAN		
	K1462_HUMAN		
	CA173_HUMAN		
	SAA_HUMAN		
	LR16B_HUMAN		
	TMSL1_HUMAN		
	KV107_HUMAN		
	CA063_HUMAN		
	PVRL3_HUMAN		
	TIG3_HUMAN		
	KV103_HUMAN		
	KV313_HUMAN		
	CC147_HUMAN		
	TIMD1_HUMAN		
	LV106_HUMAN		
	KV309_HUMAN		
	CN053_HUMAN		
	RFRP_HUMAN		
	CCD11_HUMAN		
	HV103_HUMAN		
	HELC1_HUMAN		
	HV302_HUMAN		
	AXN1_HUMAN		
	ALO17_HUMAN		
	LR10L_HUMAN		
	S72L3_HUMAN		
	K0819_HUMAN		
	HV208_HUMAN		
	YS027_HUMAN		
	KV205_HUMAN		
	HV315_HUMAN		
	ACCN4_HUMAN		
	F27E2_HUMAN		
	CV030_HUMAN		
	CP058_HUMAN		
	F100B_HUMAN		
	HV312_HUMAN		
	HV209_HUMAN		
	CB077_HUMAN		
	LV202_HUMAN		
	HSP71_HUMAN		
	VSIG6_HUMAN		
	CB029_HUMAN		
	CT072_HUMAN		
	KV312_HUMAN		
	HV206_HUMAN		
	CI093_HUMAN		
	CCD19_HUMAN		
	KV204_HUMAN		
	LV501_HUMAN		
	DOM3Z_HUMAN		
	MMP37_HUMAN		
	TTMA_HUMAN		
	WBS14_HUMAN		
	KV202_HUMAN		
	LV402_HUMAN		
	KV203_HUMAN		
	IGF1B_HUMAN		
	KV303_HUMAN		
	PAL4B_HUMAN		
	QN1_HUMAN		
	HV322_HUMAN		
	CN073_HUMAN		
	TD26_HUMAN		
	KV121_HUMAN		
	CA156_HUMAN		
	CA114_HUMAN		
	CC123_HUMAN		
	B3GN1_HUMAN		
	PM2L1_HUMAN		
	HV321_HUMAN		
	YE008_HUMAN		
	KV102_HUMAN		
	TRYA1_HUMAN		
	LV212_HUMAN		
	HV301_HUMAN		
	CG063_HUMAN		
	IL28A_HUMAN		
	SFRIP_HUMAN		
	LV203_HUMAN		
	HV107_HUMAN		
	IGF1A_HUMAN		
	F194A_HUMAN		
	HV319_HUMAN		
	CF035_HUMAN		
	KV111_HUMAN		
	IL28B_HUMAN		
	HV201_HUMAN		
	WAHS7_HUMAN		
	KV122_HUMAN		
	LV701_HUMAN		
	ATBD4_HUMAN		
	FTHFD_HUMAN		
	K1267_HUMAN		
	KV404_HUMAN		
	CN050_HUMAN		
	K0802_HUMAN		
	PSD7_HUMAN		
	KV101_HUMAN		
	K1310_HUMAN		
	RTDR1_HUMAN		
	HV318_HUMAN		
	LPLC4_HUMAN		
	CNO_HUMAN		
	LV603_HUMAN		
	LV602_HUMAN		
	TRP13_HUMAN		
	HV304_HUMAN		
	GG2L1_HUMAN		
	ACCN5_HUMAN		
	MTMRF_HUMAN		
	KV304_HUMAN		
	K1529_HUMAN		
	IL29_HUMAN		
	CA144_HUMAN		
	ENH2_HUMAN		
	CC063_HUMAN		
	HV314_HUMAN		
	CT160_HUMAN		
	HV308_HUMAN		
	KV302_HUMAN		
	KV123_HUMAN		
	KV106_HUMAN		
	CJ032_HUMAN		
	U93BL_HUMAN		
	CP088_HUMAN		
	HV207_HUMAN		
	KV108_HUMAN		
	KV118_HUMAN		
	KV113_HUMAN		
	HDMCP_HUMAN		
	LAC_HUMAN		
	CN162_HUMAN		
	LV604_HUMAN		
	CT134_HUMAN		
	VSIGL_HUMAN		
	CX025_HUMAN		
	LV404_HUMAN		
	LPPL_HUMAN		
	CI005_HUMAN		
	TM146_HUMAN		
	LV401_HUMAN		
	LV605_HUMAN		
	ELTD1_HUMAN		
	PEPA_HUMAN		
	LV102_HUMAN		
	LV103_HUMAN		
	LV108_HUMAN		
	HV104_HUMAN		
	DMP4_HUMAN		
	BA2L1_HUMAN		
	LV109_HUMAN		
	MSTP9_HUMAN		
	KV403_HUMAN		
	PR285_HUMAN		
	PLEC1_HUMAN		
	LV107_HUMAN		
	FA59A_HUMAN		
	KV104_HUMAN		
	PGCP_HUMAN		
	CN102_HUMAN		
	K1984_HUMAN		
	TMSL3_HUMAN		
	LV104_HUMAN		
	CJ018_HUMAN		
	WDR52_HUMAN		
	MACF4_HUMAN		
	HV310_HUMAN		
	KV110_HUMAN		
	KV306_HUMAN		
	LV405_HUMAN		
	LV205_HUMAN		
	ZAGL1_HUMAN		
	KV206_HUMAN		
	DCDCX_HUMAN		
	RG18L_HUMAN		
	CK081_HUMAN		
	LV601_HUMAN		
	5NT3L_HUMAN		
	MRC1L_HUMAN		
	CP068_HUMAN		
	KT81L_HUMAN		
	STUB1_HUMAN		
